शब्द	मूल	पर्याय	मूल भाषा में	रूप	Regex	Reference
अक्कास	अरबी	चित्रकार				
अक्कासी	अरबी	चित्रांकन				
अक्ल	अरबी	बुद्धी, ज्ञान, चतुराई		अक्कल, अकल	^अ(क्|क्क|क)ल$	
अक्लमंद	अरबी	बुद्धिमान, ज्ञानी, चतुर, मेधावी, 		अकलमंद , अक्लमन्द, अकलमन्द	^अ(क्|क्क|क)लम(ं|न्)द$	
अक्लमंदी	अरबी	बुद्धिमत्ता, चातुर्य		अकलमंदी, अकलमन्दी, अक्लमन्दी	^अ(क्|क्क|क)लम(ं|न्)द(ि|ी)$	
अक्ली	अरबी	तर्कसिद्ध, उचित			^अ(क्|क्क|क)ल(ि|ी)$	
अक्स	अरबी	प्रतिबिंब, चित्र,				
अक्सर	अरबी	प्रायः		अकसर	^अ(क्|क)सर$	
अकबर	अरबी	महान, श्रेष्ठ				
अकसीर	अरबी	अचूक, गुणकारी, लाभप्रद,		अक्सीर, इकसीर		
अकादमी	आङ्ग्लभाषा	विद्यापीठ,  विद्याभ्यासस्थान, 				
अकीक	अरबी	???				
अकीदत	अरबी	सम्मान, श्रद्धा, आस्था, पूजा, निष्ठा, भरोसा, विश्वास				
अकीदतमंद	अरबी	श्रद्धालु, सेवाभावी,				
अकीदा	अरबी	विश्वास, श्रद्धा,				
अकील	अरबी	बुद्धिमान, मेधावी, श्रेष्ठतम,				
अख़्तर	अरबी	तारा, ध्वज,				
अख्तियार	अरबी	अधिकार, स्वामित्व, वश, सत्ता		इख्तियार, ईख्तियार		
अखनी	अरबी	???				
अख़बार	अरबी	समाचारपत्र		अखबारों		
अख़बारी	अरबी	समाचारपत्र संबंधी				
अख़लाक	अरबी	शिष्टाचार, नीति, सदाचार				
अगर	फारसी	यदि		गर		
अगरचे	फारसी	यद्यपि, यदि,				
अगलबगल	फारसी	आसपास, सन्निकट,				
अगवा	अरबी	अपहृत				
अचारी	फारसी					आम का बना हुआ एक प्रकार का अचार।
अजनबी	अरबी	अपरिचित, नवागत				
अजब	अरबी	विचित्र, विलक्षण, अद्भुत, आश्चर्यजनक				
अज़मत	अरबी	गौरव, महत्ता, चमत्कार,				
अज़हर	अरबी	प्रकट, उज्ज्वल, प्रकाशवान, स्पष्ट,				
अज़ाब	अरबी	कष्ट, सङ्कट, यातना, पीड़ा, दण्ड				
अजायब	अरबी	अद्भुत, विचित्र, आश्चर्यजनक,				
अजायबघर	अरबी+हिन्दी 	संग्रहालय, कौतुकालय, 				
अज़ीज़	अरबी	प्रिय, आत्मीय,				
अजीब	अरबी	विचित्र, विस्मयकारी, आश्चर्यजनक		अजीबो		
अजीबोगरीब	अरबी	अद्भुत, आश्चर्यजनक, विचित्र				
अजीम	अरबी	महान, विशाल, वृद्ध				
अजूबा	अरबी	अद्भुत, अनोखा, अनन्य, अद्वितीय		अजूबों, अजूबे, अजुबे, अजूबो	^अज(ु|ू)ब(ा|(ो|े)(ं)?)$	
अजेण्डा	आङ्ग्लभाषा	कार्यसूची,  कार्यावली	agenda	एजेंडा,  एजेंडे, अजेंडा, अजेंडे, 		
अत्तार	अरबी	गंधी				
अतीक	अरबी	पुरातन, बंधनमुक्त, श्रेष्ठ,				
अदद	अरबी	संख्या, अंक, गिनती				
अदना	अरबी	तुच्छ				
अदब	अरबी	विनय, सम्मान, साहित्य,				
अदबी	अरबी	साहित्यिक				
अदम	अरबी	परलोक, अभाव,				
अदमपैरवी	अरबी+फारसी	???				1. पैरवी का अभाव 2. किसी मुकदमें आदि में पैरवी का न होना।
अदमतामील	अरबी	???				
अदममौज़ूदगी	अरबी	अनुपस्थिति,				
अदल	अरबी	न्याय				
अदा	अरबी	देना, चुकाना				
अदाएं	अरबी	हाव-भाव, मोहक चेष्टाएं, ढङ्ग		अदाओं		
अदाकारी	अरबी	अभिनय		अदाकारियाँ, अदाकारियां		
अदालत	अरबी	न्यायालय		अदालतों, अदालतो, अदालतें, अदालते		
अदालती	अरबी	न्यायिक				
अदायगी	अरबी+फारसी	भुगतान				
अदावत	अरबी	शत्रुता, वैर,				
अदावती	अरबी	शत्रु,				
अदीब	अरबी	साहित्यकार, लेखक,				
अंग्रेज	फारसी	आङ्ग्ल		अंगरेज, अँगरेज		
अंग्रेजी	फारसी	आङ्ग्ल, आङ्ग्लभाषा		अंगरेजी अँगरेजी		
अंगुश्त	फारसी	अङ्गुलि,				
अंगुश्ताना	फारसी	अङ्गुलीयक, अँगूठी,				
अंगूर	फारसी	द्राक्षा, मृद्वीका, कापिशायनी, हरहूरा		अन्गूर, अंगुर, अन्गुर		
अंगेज	फारसी	उत्तेजक, प्रेरणादायी, जनक,				
अंजाम	फारसी	परिणाम, फल, समाप्ति		अन्जाम		
अंजुमन	फारसी	सभा, संस्था,				
अंदर	फारसी	अंतर्गत, भीतर, मध्ये,				
अंदरूनी	फारसी	आंतरिक, अंतर्क्षेत्रीय, गोपनीय, भीतरी,				
अंदलीब	अरबी	???				
अंदाज़	फारसी	अनुमान, ढङ्ग, मोहक चेष्टाएँ		अन्दाज		
अंदाज़न	फारसी	प्रायः, लगभग,				
अंदाज़ा	फारसी	अनुमान , उद्भावना, धारणा,		अन्दाजा		
अंदाज़ेबयाँ	फारसी	अभिव्यक्ति कौशल,				
अंदेश	फारसी	चिंता, विचारशील,				
अन्फोर्च्यूनैट्ली	आङ्ग्लभाषा	दुर्भाग्यवश 	unfortunately 	अनफॉर्चूनेटली		
अंबार	फारसी	राशि, भंडार,				
अंसार	अरबी	सहायक				
अनलहक	अरबी	???				
अनहद	अरबी	असीम				
अनार	फारसी	दाड़िम				
अनारदाना	फारसी	???				
अनारी	फारसी	???				1. अनार संबंधी; अनार का 2. अनार के रंग का 3. चमकीला (लाल)।
अनासिर	अरबी	पंचभूत				
अनीस	अरबी	सखा, मित्र,				
अप्रूव	आङ्ग्लभाषा	स्वीकृत 	approve			
अप्कमीङ्ग्	आङ्ग्लभाषा	आगामी	upcoming 	अपकमिंग		
अपील	आङ्ग्लभाषा	याचना, निवेदन, याचिका, प्रार्थना	appeal			
अफ़लातून	अरबी	प्लेटो				
अफ़वाह	अरबी	प्रवाद		अफवाहो, अफवाहों, अफवाहे, अफवाहें, अफवाहबाजों		
अफ़सर	आङ्ग्लभाषा	अधिकारी		अफसरों		
अफ़साना	फारसी	कहानी, कथा, उपन्यास		अफसाने		
अफ़सानानवीस	फारसी	कथाकार, उपन्यासकार, लेखक,				
अफ़सानानिगार	फारसी	कथाकार, उपन्यासकार, लेखक,				
अफसोस	फारसी	पछतावा, ग्लानि, पश्चात्ताप				
अब्बा	फारसी	पिता				
अब्बाजान	फारसी	पिता				
अब्बास	अरबी	सिंह				
अब्बू	फारसी	पिता				
अब्र	फारसी	बादल, मेघ, घटा				
अबरस	फारसी	चितकबरा				
अबरा	फारसी	उपल्ला, उलझन, समस्या,				
अबरी	फारसी	???				1. एक प्रकार का धारीदार चिकना कागज़ 2. एक प्रकार का पीला पत्थर 3. एक प्रकार की लाख की रँगाई।
अबलक	अरबी	चितकबरा				
अबादान	अरबी	संपन्न, समृद्ध,				
अबोर्शन्	आङ्ग्लभाषा	गर्भपात,  	abortion 	अबोर्शन, अबॉर्शन, 		
अमन	अरबी	शान्ति, सुव्यवस्था				
अमनचैन	अरबी	सुख-शांति , सुरक्षा				
अमल	अरबी	कार्य, आचरण, अधिकार, प्रभाव, समय				
अमलदरामद	अरबी	कार्रवाई,				
अमलदार	अरबी+फारसी	शासक, अधिकारी				
अमलदारी	अरबी+फारसी	राज्य, शासन, अधिकार				
अमला	अरबी	कर्मचारीगण				
अमलारा	अरबी	प्रमादी,				
अमली	अरबी	व्यावहारिक,				
अमानत	अरबी	न्यास, उपनिधि, धरोहर				
अमानती	अरबी	???				
अमीन	अरबी	विश्वसनीय				
अमीनी	अरबी	विश्वसनीयता				
अमीर	अरबी	धनवान		अमीरों		
अमीरजादा	अरबी+फारसी	???		अमीरजादी		
अमीरी	अरबी	धनाढ्यता, वैभवशालिता				
अमूमन	अरबी	साधारणतः, प्रायः,				
अय्याश	अरबी	विलासी, लंपट, कामुक, व्यभिचारी,				
अय्याशी	अरबी	विलासिता, कामुकता, लंपटता, व्यभिचार, अश्लीलता				
अयाल	फारसी	केसर, रोम,				
अर्क	अरबी	रस, स्वेद , सत्व,		अरक		
अर्ज़	फारसी	प्रस्तुत				
अर्जी	अरबी	प्रार्थनापत्र, आवेदनपत्र, विनती		अरज़ी		
अर्ज़ीदावा	अरबी	निवेदनपत्र		अरजीदावा		
अरकान	अरबी	स्तंभ, मुख्यमंत्री, वैभव, संपत्ति				
अरस्तू	ग्रीक	ऐरिस्टॉटल				
अरसा	अरबी	समय, काल, अवधि, विलंब		अरसे		
अरेस्ट	आङ्ग्लभाषा	धरपकड	arrest			
अब्सार	अरबी	आँखे, नयन, नेत्र				
अरमान	तुर्की	इच्छा, कामना		अरमानों, अरमानो		
अल्फाज़	अरबी	वाक्य, शब्दों		अल्फाजों, अल्फाजो, अलफाज, अलफाजों, अलफाजो		
अल्ल	अरबी	वंश, कुल				
अल्लामा	अरबी	ज्ञाता, बुद्धिमान, विद्वान, पण्डित				
अलकतरा	अरबी	डामर				
अलग़ोजा	अरबी	बाँसुरी				
अलबत्ता	अरबी	किंतु, परंतु, निस्संदेह,				
अलंबरदार	अरबी+फारसी	ध्वजवाहक, मार्गदर्शक,				
अलम	अरबी	दुख, कष्ट, व्यथा, पीड़ा,				
अलमनाक	अरबी	दुखमय, दुखद,				
अलमस्त	फारसी	मदमत्त				
अलमस्ती	फारसी	मतवालापन				
अलर्ट	आङ्ग्लभाषा	चेतावनी,	alert	एलर्ट	^(अ|ए)लर्ट(्|्स्|्स)?$	
अलवान	अरबी	???				
अलविदा	अरबी	नमस्कार	الوَدَاع			
अलहदगी	अरबी	पार्थक्य, निरालापन, न्यारापन				
अलहदा	अरबी	अलग, अद्वितीय,				
अलामत	अरबी	चिह्न, लक्षण, उदाहरण		अलामात		
अलाव	फारसी	कौड़ा				
अलावा	अरबी	अतिरिक्त		इलावा		
अलील	अरबी	रुग्ण, रोगी				
अव्वल	अरबी	प्रथम, उत्तम श्रेष्ठ, प्रारम्भ, सर्वोत्तम, मुख्य				
अवेस्ता	फारसी					पारसियों का मूल धर्मग्रंथ।
अवोर्ड्	आङ्ग्लभाषा	पुरस्कार 	award	अवॉर्ड, अवार्ड्स, अवोर्ड		
अशरफ़	फारसी	उच्च, स्वर्ण मुस्लिम		अशराफ		
अशरफ़ी	फारसी	मुद्रा				
अस्तबल	अरबी	अश्वशाला				
अस्पताल्	आङ्ग्लभाषा	चिकित्सालय, रुग्णालय	hospital	अस्पतालों, अस्पताल		
अस्मत	अरबी	पतिव्रत, सतीत्व,				
अस्सलाम	अरबी	नमस्कार				
असगर	अरबी	साधारण, छोटा				
असद	अरबी	सिंह				
असबाब	अरबी	सामग्री, वस्तु,				
असर	अरबी	प्रभाव				
असरकारी	अरबी	गुणकारी, लाभकारी				
असरार	अरबी	रहस्य	أسرار			
असल	अरबी	सत्य, यथार्थ, वास्तविक				
असलह	अरबी	अस्त्र, हथियार,				
असलहख़ाना	अरबी+फारसी	शस्त्रागार				
असलहा	अरबी	अस्त्र-शस्त्र; हथियार,				
असलियत	अरबी	वास्तविकता, मौलिकता, यथार्थता				
असली	अरबी	सच्चा, शुद्ध, मूल				
असासा	अरबी	धन, सम्पत्ति, पूँजी		असासह		
अहकाम	अरबी	नियम , आज्ञाएँ				
अहकामात	अरबी	नियम , आज्ञाएँ				
अहदनामा	अरबी+फारसी	प्रतिज्ञापत्र, शपथपत्र				
अहबाब	अरबी					
अहम	अरबी	महत्त्वपूर्ण, गम्भीर				
अहमक	अरबी	मूर्ख				
अहमकाना	अरबी	मूर्खतापूर्ण				
अहमद	अरबी	प्रशंसनीय				
अहमियत	अरबी	महत्व, गम्भीरता				
अहल	अरबी	व्यक्ति, मुख्य, योग्य,				
अहलकारी	अरबी+फारसी	???				अहलकार का काम; कारिंदागिरी।
अहसास	अरबी	अनुभव, प्रतीति		अहसासों		
अहाता	अरबी	घेरा				
						
आइंदा	फारसी	आगे, आगामी, भविष्य में, भविष्य,		आयंदा		
आइसोलेशन	आङ्ग्लभाषा	एकान्त,				
आईना	फारसी	दर्पण		आइना, आईने, आइने		
आका	तुर्की	स्वामी		आकाओं		
आक़िबत	अरबी	अन्त, परिणाम, भविष्य				
आख़्ता	फारसी	???				जिसके अंडकोश काट या निकाल दिए गए हों; बधिया।
आखिर	अरबी	अन्त में, अन्ततः				
आखिरकार	अरबी	अन्ततः				
आखिरी	अरबी	अंतिम		आखरी		
आगा	तुर्की	अग्रज				
आगाह	फारसी	ज्ञात, सूचित, सचेत				
आगाही	फारसी	चेतावनी, सूचना, भविष्यवाणी,				
आपा	तुर्की	अग्रजा				
आगाज़	अरबी	आरम्भ, प्रारम्भ, लक्षण				
आगोश	अरबी+फारसी	आलिङ्गन				
आज़म	अरबी	बड़ा, महान,				
आज़माइश	फारसी	परीक्षा, परीक्षण,				
आज़माइशी	फारसी	???				1. आज़माइश के तौर पर किया हुआ 2. आज़माइश संबंधी।
आज़माना	फारसी	परखना, प्रयास करना, परीक्षण करना,				
आजाद	फारसी	मुक्त, स्वतन्त्र				
आजादी	फारसी	स्वतन्त्रता, स्वाधीनता, मुक्ति				
आजिज़	अरबी	विवश, शक्तिहीन, उदासीन				
आजिज़ी	अरबी	विवशता, नम्रता, विनती,				
आतशी	फारसी	???				1. आतिश या आग से संबंध रखने वाला 2. आग से पैदा होने वाला 3. आग की लपट जैसा लाल 4. अग्नि-उत्पादक।
आतिश	फारसी	अग्नि, ज्वाला, क्रोध, आवेश		आतश		
आतिशबाजी	फारसी	पटाखा, अग्निकीड़ा				
आदत	अरबी	व्यसन, लत, स्वभाव, प्रकृति, अभ्यास		आदतें, आदतों, आदते, आदतो		
आदतन	अरबी	स्वभावतः				
आदम	अरबी	मनुष्य, व्यक्ति, आदिपुरुष				
आदमकद	अरबी	???				
आदमखोर	अरबी+फारसी	नरभक्षी, मानवभक्षी				
आदमी	अरबी	मनुष्य, व्यक्ति	آدمي			
आदमियत	अरबी	मनुष्यत्त्व, मनुष्यता, शिष्टता				
आदाब	अरबी	शिष्टाचार, नियम, रीति, अभिवादन				
आदिल	अरबी	न्यायप्रिय, न्यायी,				
आननफानन	अरबी	तत्काल, अचानक, एकाएक				
आफ़त	अरबी	सङ्कट, विपत्ति, विपदा, दुःख		आफ़तों, आफतें		
आफ़ताब	फारसी	सूर्य		आफताबों		
आफरीन	अरबी	धन्य				
आब	फारसी	पानी, जल, प्रतिष्ठा, कांति, शोभा,				
आबकार	फारसी	कलवार, कलाल				
आबदार	फारसी	आभायुक्त, जलयुक्त, प्रतिष्ठित, स्वाभिमानी,				
आबदारी	फारसी	???				आबदार होने का गुण, अवस्था या भाव।
आबनूस	फारसी	तेंदू				
आबपाशी	फारसी	सिंचाई				
आबरू	फारसी	प्रतिष्ठा, मान, सम्मान, आदर		आबरु		
आबाई	अरबी	पैतृक				
आबाद	फारसी	सुखी, समृद्ध, प्रसन्न				
आबादकार	फारसी	कृषक				
आबादी	फारसी	जनसंख्या				
आबिद	अरबी	पुजारी, भक्त				
आबोदाना	फारसी	अन्नजल, खानपान, आजीविका,				
आबोहवा	फारसी	जलवायु		अबोहवा		
आम	अरबी	साधारण, सामान्य				
आमजन	अरबी+हिन्दी	सामान्य नागरिक				
आमतौर	अरबी	प्रायः, सामान्यतः				
आमदनी	फारसी	आय, आजीविका, अर्थप्राप्ति, अर्जन				
आमफ़हम	अरबी	जनसाधारण				
आमिर	अरबी	अधिकारी				
आमीन	अरबी	तथास्तु, एवमस्तु				
आमिल	अरबी	कार्यकर्ता, अधिकारी, प्रधान, तांत्रिक, सिद्ध, शासक,				
आर्म्स्	आङ्ग्लभाषा	हथियार, शस्त्र, आयुध, 	arms	आर्म्स		
आर्मी	आङ्ग्लभाषा	सेना	army			
आरजू	फारसी	इच्छा, कामना, अभिलाषा				
आराज़ी	अरबी	भूमि				
आरामकुरसी	फारसी	विश्रामासान				
आरामदेह	फारसी	शान्तिप्रद, विश्रामदायक,				
आरास्ता	फारसी	सुसज्जित				
आरिफ़	अरबी	ज्ञानी				
आलम	अरबी	दशा, दृश्य, जनसमूह, संसार, जगत्				
आलमगीर	अरबी+फारसी	विश्वविजयी, विश्वव्यापी				
आलमी	अरबी	लौकिक, सांसारिक				
आला	अरबी	उत्तम, श्रेष्ठ, उपकरण				
आलाकमान	अरबी+फारसी	सर्वोच्च पदाधिकारी				
आलिम	अरबी	विद्वान				
आलिमाना	अरबी+फारसी	विद्वान समान				
आली	अरबी	ऊँचा, बड़ा, श्रेष्ठ, उत्तम, मान्य,				
आलीजनाब	अरबी	महोदय				
आलीशान	अरबी	भव्य, विशाल,				
आलूचा	फारसी	???				1. एक रसीला और खट्टा-मीठा फल 2. उक्त फल का पेड़।
आलूबुख़ारा	फारसी	???				1. एक खट्टा-मीठा और रसीला फल जिसमें बड़ी गुठली निकलती है 2. उक्त फल का पेड़।
आवाज	फारसी	पुकार, ध्वनि, स्वर, नाद		अवाज, आवाजें, आवाजों		
अवाम	अरबी	जनता, प्रजा, गण		आवाम		
आवारग़ी	फारसी	लम्पटता				
आवारा	फारसी	चञ्चल, लम्पट, आलसी				
आवारागर्दी	फारसी	लम्पटता				
आवारापन	फारसी	लम्पटता				
आशना	फारसी	प्रेमी, प्रेमिका, मित्र, परिचित , 		आश्ना		
आशिक	अरबी	प्रेमी, आसक्त		आशिकों		
आशिकाना	अरबी+फारसी	अनुरागमय,				
आशिकमिज़ाज	अरबी	प्रेमप्रवण, विलासी,				
आशिकी	अरबी	प्रेमासक्ति,				
आशियाना	फारसी	घर, घोंसला		आशियाँ , आशियाने		
आस्तीन	फारसी	बाँह				
आसमान	फारसी	आकाश, गगन, नभ		आसमा, आसमाँ, आस्मां, आसमानों, आसमानो, आसमानी , आसमां		
आसान	फारसी	सरल, सुगम, सहज		आसां, आसाँ		
आसानी	फारसी	सरलता, सहजता, सुगमता, अनायास				
						
इकदार	???	???				
इकबाल	अरबी	प्रताप, भाग्य, वैभव, स्वीकृति,				
इकबालमंद	अरबी	प्रतापी, ऐश्वर्यशाली				
इकबालिया	अरबी	आत्मस्वीकृति				
इकबाली	अरबी	अभियुक्त				
इकराम	अरबी	पुरस्कार, पारितोषिक, अनुग्रह				
इकरार	अरबी	वचन, घोषणा, स्वीकृति, प्रण, प्रतिबद्धता			^(इ|ई)करार(्)?$	
इकरारनामा	अरबी+फारसी	शपथपत्र, प्रतिज्ञापत्र,			^(इ|ई)करार(्)?नामा$	
इकरारी	अरबी	प्रतिबद्ध				
इख़्तियार	अरबी	नियंत्रण, सामर्थ्य, अधिकार				
इख़्तियारी	अरबी	???				
इख़्तिलात	अरबी	अनुराग, प्रेम-भाव, आलिंगन,				
इख़्तिलाफ़	अरबी	वैमनस्य, विरोध, मतभेद,				
इख़्तिसार	अरबी	संक्षेपण				
इख़राज	अरबी	बहिष्कार				
इख़लास	अरबी	सरलता, निश्छलता,				
इज्जत	अरबी	प्रतिष्ठा, मान, सम्मान, आदर				
इज्जतदार	अरबी	प्रतिष्ठित, सम्मानित, कीर्तिमान्, संभावित				
इजलास	अरबी	अधिवेशन, बैठक, सभा, न्यायालय,				
इज़हार	अरबी	व्यक्त, स्पष्ट, प्रदर्शित	إظهار			
इजाज़त	अरबी	अनुमति, आज्ञा				
इजाफा	अरबी	वृद्धि	اضافہ	इजाफे		
इजारा	अरबी	ठेका, अधिकार, स्वत्व,				
इजारादार	अरबी+फारसी	काश्तकार				
इजारानामा	अरबी+फारसी	अधिकारपत्र, स्वत्वपत्र,				
इत्तफ़ाकइ	अरबी	मतैक्य, सहमति, संयोग,				
इत्तफ़ाकन	अरबी	संयोग से				
इत्तला	अरबी	सूचना		इत्तिला		
इत्तलानामा	अरबी	सूचनापत्र				
इत्तहाद	अरबी	मित्रता, एकता,		इत्तिहाद		
इत्तिहादी	अरबी	एकतामूलक				
इत्तेफाक	अरबी	संयोग, अचानक, सहमति		इत्तफाक, इतेफाक		
इत्तेहादुल	???	???				
इत्र	अरबी	???				
इतमीनान	अरबी	संतोष, समाधान, विश्वास, भरोसा,		इत्मीनान		
इन्क्यूबेशन्	आङ्ग्लभाषा	कुलायनिलाय, उद्भवन, ऊष्मायन	incubation 	इन्क्यूबेशन		
इन्कम्	आङ्ग्लभाषा	आय,	income	इनकम, इन्कम, इंकम		
इन्कलाब	अरबी	क्रांति, राज्यपरिवर्तन	اِنْقِلَاب	इनकलाब, इंकलाब		
इन्कलाबी	अरबी	क्रांतिकारी		इनकलाबी		
इंजीनियरिंग	आङ्ग्लभाषा	अभियान्त्रिकी	engineering 	इन्जीनियरिंग		
इंटर्नेश्नल्	आङ्ग्लभाषा	अन्तरराष्ट्रीय	international 	इंटरनेशनल, इनटरनेशनल, 		
इंडियन्	आङ्ग्लभाषा	भारतीय	indian	इंडियन, इण्डियन, इंडियंस 		
इंडिया 	आङ्ग्लभाषा	भारत 	india	इन्डिया		
इंतकाम	अरबी	प्रतिशोध		इन्तकाम, ईंतकाम, ईंन्तकाम		
इंतक़ाल	अरबी	मृत्यु, देहांत, अवसान		इन्तकाल		
इंतजाम	अरबी	प्रबंध, व्यवस्था, आयोजन		इन्तजाम, इंतजामात, इंतिजाम		
इंतज़ामिया	अरबी	प्रबन्धक				
इंतजार	अरबी	प्रतीक्षा		इंतेज़ार, इन्तजार, इंतिजार		
इन्तशार	अरबी	बिखरना, अस्त-व्यस्तता, उद्विग्नता		इंतशार		
इन्तहा	अरबी	अन्त, सीमा		इंतहा, इन्तेहा, इंतेहा, इंतिहा, इन्तिहा, इन्तहां		
इन्तहाई	अरबी	अंतिम, चरम, पराकाष्ठागत, अत्याधिक,		इंतहाई		
इन्तिख़ाब	अरबी	चयन, निर्वाचन		इंतख़ाब, इंतिख़ाब		
इंदराज	फारसी	प्रविष्टि				
इन्नोवेटर्	आङ्ग्लभाषा	अन्वेषक, नवरीतिस्थापक, नूतनव्यवहारस्थापक, 	innovator		^(इ|ई)(न|न्न)ोवेट(र्|र|र्स|र्स्)$	
इन्फ्रास्ट्रक्चर् 	आङ्ग्लभाषा	आधारभूतसंरचना	infrastructure 	इन्फ्रास्ट्रक्चर		
इन्साइड्	आङ्ग्लभाषा	भीतर, आन्तरिक, गुप्त, 	inside			
इंसान	अरबी	मनुष्य, मानव	انسان	इंसानो, इंसानों, इन्सान, इनसान		
इन्सानी	अरबी	मानवीय		इनसानी, इंसानी		
इंसाफ़	अरबी	न्याय		इन्साफ, इनसाफ़,		
इंसानियत	अरबी	मानवता		इन्सानियत, इनसानियत,		
इनकार	अरबी	अस्वीकार, नकार		इंकार, इन्कार		
इनकारी	अरबी	नकारात्मक				
इनकिसार	अरबी	विनम्रता, विनयशीलता				
इनाम	अरबी	पुरस्कार, पारितोषिक		ईनाम, इनामी, ईनामी		
इनायत	अरबी	कृपा				
इफ़रात	अरबी	विपुलता, प्राचुर्य, बाहुल्य, अधिक,				
इफ़लास	अरबी	दरिद्रता				
इफ़ाका	अरबी	स्वास्थ्य लाभ, रोगमुक्ति,				
इब्तिदा	अरबी	आरम्भ, प्रारम्भ, जन्म, उत्पत्ति, अनुष्ठान				
इब्न	अरबी	पुत्र				
इबरत	अरबी	विचित्रता, शिक्षा				
इबरानी	अरबी	यहूदी				
इबादत	अरबी	आराधना, पूजा, अर्चना, उपासना, वंदना		इबादात		
इबारतआराई	अरबी+फारसी	शब्दाडंबर				
इबारत	अरबी	लिखावट, वाक्यरचना, लेख, लेखन शैली, श्रुतलेख,				
इम्तहान	अरबी	परीक्षा		इम्तिहान, इम्तिहाँ, इम्तिहां, इम्तिहानो, इम्तहानो, इम्तेहान, इम्तेहाँ, इम्तेहां, इम्तेहानो		
इम्तिनाई	अरबी	निषेधक, प्रतिबंधक,		इम्तिनाय		
इम्तियाज़	अरबी	भेद, अंतर, विवेक, विशेषता,				
इम्यूनिटी	आङ्ग्लभाषा	रोग प्रतिरोधक शक्ति, प्रतिरक्षा,	immunity 			
इमरजेंसी	आङ्ग्लभाषा	आपातकालीन, आपातकाल	emergency 	इमर्जेंसी		
इमदाद	अरबी	सहायता, सहयोग,				
इमदादी	अरबी	लाभार्थी				
इमला	अरबी	अनुलेख, श्रुतलेख,				
इमलाक	अरबी	संपत्ति,				
इमामत	अरबी	नेतृत्व				
इमामदस्ता	अरबी+फारसी	???				जड़ी-बूटी आदि को कूटने-पीसने के लिए प्रयोग किया जाने वाला धातु का खल-बट्टा।
इमारत	अरबी	भवन				
इमारती	अरबी	???				
इमोशनल्	आङ्ग्लभाषा	भावुक, 	emotional 	इमोशनल		
इर्साल	अरबी	भेंट,				
इरफ़ान	अरबी	बुद्धि, विवेक, ज्ञान,				
इरशाद	अरबी	आज्ञा, आदेश, पथप्रदर्शन,				
इरादतन	अरबी	विचारपूर्वक, संकल्पपूर्वक,				
इरादा	अरबी	विचार, इच्छा, आशय, उद्देश्य		इरादे, इरादें, इरादों, इरादो		
इल्ज़ाम	अरबी	आरोप, अभियोग, दोषारोपण,		ईल्ज़ाम, इल्जामात, इलज़ाम		
इल्ताफ़	अरबी	कृपा, दया,				
इल्लत	अरबी	दुर्व्यसन, कारण, अपराध, दोष, त्रुटि, संकट, रोग,				
इल्तिजा	अरबी	प्रार्थना, विनती, निवेदन,				
इल्म	अरबी	ज्ञान , विद्या , विज्ञान				
इल्मियत	अरबी	विद्वता, पांडित्य,				
इल्मी	अरबी	???				
इल्मेअदब	अरबी	साहित्यशास्त्र				
इल्मेइलाही	अरबी	ब्रह्माविद्या, अध्यात्म				
इल्मेगैब	अरबी	परोक्षविज्ञान				
इल्मेनुजूम	अरबी	ज्योतिषशास्त्र				
इलहाक	अरबी	जोड़ना, क्षेपक,				
इलहाम	अरबी	???				
इलाक़ा	अरबी	क्षेत्र, प्रदेश, स्थान		इलाके, इलाकों, इलाको		
इलाकाई	अरबी	प्रादेशिक, क्षेत्रीय,				
इलाज	अरबी	उपचार, उपाय, निराकरण		ईलाज		
इलाही	अरबी	अल्लाह, अल्लाह का				
इलेक्ट्रिक्	आङ्ग्लभाषा	वैद्युत, विद्युत्वान्	electric 	इलेक्ट्रिक		
इलेक्ट्रिसिटी 	आङ्ग्लभाषा	विद्युत्, वज्रस्फुलिङ्ग, 	electricity 			
इवेंट्	आङ्ग्लभाषा	घटना, स्पर्धा, 	event	इवेंट, इवेंट्स, इवेंट्स्		
इश्क़	अरबी	प्रेम, आसक्ति				
इश्कबाज	अरबी+फारसी	प्रेमी, आसक्त				
इश्कबाजी	अरबी+फारसी	व्याभिचार				
इश्किया	अरबी	???				
इश्केमजाजी	अरबी+फारसी	सांसारिक प्रेम				
इश्केहकीकी	अरबी+फारसी	ईश्वरीय प्रेम				
इश्तिआल	अरबी	भड़काना, उत्तेजित,				
इश्तियाक	अरबी	इच्छा, लालसा, उत्कंठा,				
इश्तिराक	अरबी	साझेदारी, भागीदारी, साम्यवाद,				
इश्तिहा	अरबी	भूख, क्षुधा, इच्छा,				
इश्तिहार	अरबी	विज्ञापन, प्रचार, सूचना, घोषणा		इश्तहार, इश्तेहार, इश्तिहारों, इश्तिहारो,		
इश्तहारी	अरबी	विज्ञापित				
इशरत	अरबी	सुख-भोग, आनंद-मंगल,				
इशाअत	अरबी	प्रकटन, प्रचार, प्रसार, संस्करण,				
इशारतन	अरबी	सांकेतिक				
इशारा	अरबी	सङ्केत		इशारे, इशारों, इशारो, इशारें		
इशारेबाज़ी	अरबी	???				
इस्कात	अरबी	चुप कर देना				
इस्तकबाल	अरबी	स्वागत		इस्तेकबाल, ईस्तकबाल, ईस्तेकबाल		
इस्तगासा	अरबी	अभियोग,				
इस्मतफरोश	अरबी+फारसी	वेश्या				
इस्तमरार	अरबी	स्थायित्व,				
इस्तमरारी	अरबी	स्थायी,				
इस्तिकलाल	अरबी	दृढ़ता,				
इस्तीफा	अरबी	त्यागपत्र		इस्तीफों, इस्तीफे		
इस्तिलाह	अरबी	???				
इस्तिलाही	अरबी	लाक्षणिक, पारिभाषिक,				
इस्तेमाल	अरबी	उपयोग, प्रयोग		ईस्तेमाल, इस्तमाल, ईस्तमाल		
इस्तेमाली	अरबी	उपयोगी				
इस्पात	पुर्तगाली	???				
इस्म	अरबी	नाम, संज्ञा,				
इस्मत	अरबी	सतीत्व, पातिव्रत्य,				
इस्मेशरीफ़	अरबी	शुभनाम				
इस्लाह	अरबी	सुधार, संशोधन		इस्लाहे		
इसबगोल	फारसी	???				1. औषधि के रूप में प्रयुक्त एक पौधा 2. उक्त पौधे के सफ़ेद बीजों से बनी हुई दवा जो उदर या पेट के विकारों को दूर करती है।
इसराफ़	अरबी	अपव्यय				
इसरार	अरबी	आग्रह, हठ,				
इसलाह	अरबी	सुधारना, संशोधन,				
इसहाल	अरबी	अतिसार,				
इहाता	अरबी	क्षेत्र				
						
ईजाद	अरबी	अविष्कार, नवनिर्माण,				
ईमन	फारसी	???				(संगीत) एक प्रकार की रागिनी जिसे रात के पहले पहर में गाया जाता है।
ईमा	अरबी	संकेत, तात्पर्य, आदेश,				
ईजादी	अरबी	अविष्कारी,				
ईमान	अरबी	अल्लाह पर विश्वास		इमान		
ईमानदार	अरबी	[मूल अर्थ: जिसे अल्लाह पर विश्वास है] प्रामाणिक, सत्यनिष्ठ, निष्कपट		इमानदार		
ईमानदारी	अरबी+फारसी	[मूल अर्थ: अल्लाह पर विश्वास] प्रामाणिकता, निष्कपटता, सत्यनिष्ठा, धर्मनिष्ठता		इमानदारी		
ईमाय	अरबी	ध्वनि, संकेत,				
ईस्ट	आङ्ग्लभाषा	पूर्व				
ईसार	अरबी	त्याग, स्वार्थत्याग,				
						
उकाब	अरबी	गिद्ध, गरुड़,				
उज्र	अरबी	विरोध, आपत्ति,				
उज्रदार	अरबी+फारसी	आपत्तिकर्ता, विरोधकर्ता				
उज्रदारी	अरबी+फारसी	आपत्तिपत्र				
उजबक	तुर्की	मुर्ख				
उजरत	अरबी	पारिश्रमिक				
उदूल	अरबी	अवज्ञा, उल्लंघन,				
उदूलहुक्मी	अरबी	अवज्ञा, उल्लंघन,				
उन्वान	अरबी	शीर्षक				
उफ़क	अरबी	क्षितिज,				
उम्दगी	अरबी	श्रेष्ठता				
उम्दा	अरबी	उत्तम, श्रेष्ठ, प्रशंसनीय		उमदा		
उम्मा	अरबी	महम्मदन समुदाय		उम्मत, उम्मते		
उम्मीद	फारसी	आशा, अपेक्षा		उम्मीदें, उमीद, उम्मीदों , उम्मेद,		
उम्मीदवार	फारसी	प्रत्याशी		उम्मीदवारों		
उम्र	अरबी	आयु, वय		उमर, ऊम्र, ऊमर		
उम्रकैद	अरबी	आजीवन कारावास		उमरकैद		
उम्रदराज	अरबी+फारसी	वयोवृद्ध				
उम्रभर	अरबी	जीवनपर्यंत, जीवनभर				
उमरा	अरबी	धनिक				
उमराव	अरबी	प्रतिष्ठित, धनिक, धनवान				
उर्दू	तुर्की	सेनावास				
उर्फ	अरबी	उपनाम				
उर्स 	अरबी	मुसलमानी पीर की निर्वाण तिथि				
उरूज	अरबी	उन्नति, उत्थान, वृद्धि,				
उल्फ़त	अरबी	प्रेम, प्रीति, स्नेह, मित्रता		उलफ़त		
उलमा	अरबी	विद्वान,				
उलूम	अरबी	शास्त्र, विद्याएँ,				
उस्तानी	फारसी	शिक्षिका, अध्यापिका, गुरुमाता				
उसूल	अरबी	सिद्धान्त, नियम		उसूलों , असूल		
उसूलन	अरबी	नियमानुसार, सिद्धांततः,				
उसूली	अरबी	सैद्धांतिक,				
						
एक्ट्	आङ्ग्लभाषा	अधिनियम,  विधि, कार्य,  कर्म,  नियम, अभिनय,  	act	ऐक्ट, ऐक्ट्, एक्ट,		
एक्ट्रेस्	आङ्ग्लभाषा	अभिनेत्री	actress	एक्ट्रेस		
एक्टर्	आङ्ग्लभाषा	अभिनेता	actor	एक्टर्स, एक्टर		
एक्टिव्	आङ्ग्लभाषा	सक्रिय	active	एक्टिव		
एक्टिवेट्	आङ्ग्लभाषा	सक्रिय	activate 	एक्टिवेट		
एक्स्प्रेस्	आङ्ग्लभाषा	द्रुतगति, द्रुतगामी, व्यक्त, अभिव्यक्त, प्रकट, 	express	एक्सप्रेस		
एक्स्पर्ट्	आङ्ग्लभाषा	निष्णात, निपुण, विशेषज्ञ	expert	एक्सपर्ट, एक्स्पर्ट		
एक्स्पोज्	आङ्ग्लभाषा	उजागर	expose	एक्सपोज, एक्स्पोज		
एक्स्पोर्ट्	आङ्ग्लभाषा	निर्यात	export	एक्सपोर्ट, 		
एकफ़सला	फारसी	???				वह (खेत या भूमि) जिसमें वर्ष भर में एक ही फ़सल होती है; एकफ़सली।
एकबारगी	फारसी	एकाएक, अकस्मात, अचानक,				
एकमुश्त	फारसी	इकट्ठा, संपूर्ण,				
एकसर	फारसी	अकेला				
एकाउन्ट्	आङ्ग्लभाषा	खाता, गणना, 	account	एकाउंट, एकाउंट्स, एकाउंट्स्		
एग्जाम्	आङ्ग्लभाषा	परीक्षा, परीक्षण, अवलोकन, 	exam	एग्जाम		
एग्रीमेंट्	आङ्ग्लभाषा	समझौता, सहमति, अनुबंध, 	agreement	एग्रीमेंट	^एग्र(ि|ी)मे(न्|ं|ण्)ट(्)?$	
ऐज्	आङ्ग्लभाषा	आयु, वय	age	ऐज,		
एजाज़	अरबी	चमत्कार,				
एजेन्सी	आङ्ग्लभाषा	संस्था, कर्तृकत्व, 	agency	एजेंसी, ऐजेंसी, एजेंसियों, एजेंसियां, एजेंसीज, 		
एड्मिनिस्टर्	आङ्ग्लभाषा	प्रशासन/शासन/प्रबन्ध/वितरण करना, देना	administer	एडमिनिस्टर		
एतकाद	अरबी	श्रद्धा, आस्था, विश्वास,				
एतमाद	अरबी	विश्वास, निर्भरता,				
एतराज	अरबी	आपत्ति		ऐतराज		
एतराफ़	अरबी	स्वीकृति				
एन्काउण्टर्	आङ्ग्लभाषा	सामना, समागम, समाघात, सम्प्रहार, युद्ध, 	encounter	एनकाउंटर, एन्काउंटर, एंकाउंटर	^ए(न|न्|ङ्|ं)काउ(न्|ं|ण्)टर(्)?$	
एङ्गेज्मेन्ट्	आङ्ग्लभाषा	व्यापार, कार्य, कर्म, प्रवृत्ति, व्यवहार, व्यवसाय, युद्ध, प्रतिज्ञा, विवाहप्रतिज्ञा, 	engagement 		^(ए|इ)(न्|ं|ङ्)गेज(्)?मे(न्|ं|ण्)ट(्)?$	
एंट्री 	आङ्ग्लभाषा	प्रवेश	entry	एन्ट्री		
एंटी	आङ्ग्लभाषा	विरुद्ध, विरोधी 	anti			
एपिसोड	आङ्ग्लभाषा	प्रकरण	episode			
एफिडेविट्	आङ्ग्लभाषा	शपथपत्र	affidavit	एफिडेविट		
एम्बुलेंस्	आङ्ग्लभाषा	रुग्णयान	ambulance	एंबुलेंस, एम्ब्युलेन्स, एम्बुलेन्स, एम्बुलेंस	^ए(म्|ं)ब(्य)?ुले(न्|ं)स(्)?$	
एर्	आङ्ग्लभाषा	वायु, पवन, आकाश, वात, समिर, 			^ए(य)?र(्)?$	
एयर्पोर्ट्	आङ्ग्लभाषा	विमानमथक	airport	एअरपोर्ट, एरपोर्ट, एयरपोर्ट		
एलची	तुर्की	पत्रवाहक, राजदूत,				
एलान	अरबी	घोषणा		ऐलान		
एलानिया	अरबी	स्पष्ट रूप से, सार्वजनिक,				
एलानेजंग	अरबी+फारसी	युद्धघोषणा				
एवज़	अरबी	प्रतिफल, स्थानापन्न,				
एवज़ी	अरबी	स्थानापन्न				
ऐवान	फारसी	राजभवन, परिषद, संसद,				
एविएशन्	आङ्ग्लभाषा	विमानन, विमानवहन, वैमानिकी, 			^एव(ि|ी)एशन(्)?$	
एहतराम	अरबी	सम्मान				
एहतशाम	अरबी	वैभव, ऐश्वर्य, प्रतिष्ठा,				
एहतिमाम	अरबी	आयोजन, प्रबंध, व्यवस्था, निरीक्षण, तत्वावधान,				
एहतिमाल	अरबी	आशंका, संदेह,				
एहतियाज	अरबी	अभाव, आवश्यकता,				
एहतियात	अरबी	सावधानी, विवेचन				
एहतियातन	अरबी	सावधानीपूर्वक, सतर्कता से,				
एहतियाती	अरबी	???				
एहतिलाम	अरबी	स्वप्नदोष				
एहतिसाब	अरबी	आत्मचिन्तन		एहतेसाब		
एहसास	अरबी	अनुभव, प्रतीति		अहसासों, अहसास, एहसासों, एहसासो		
एहसान	अरबी	अनुग्रह, कृपा		अहसान		
एहसानफ़रामोश	अरबी+फारसी	कृतघ्न		अहसानफ़रामोश		
एहसानमंद	अरबी+फारसी	कृतज्ञ		एहसानमन्द , अहसानमंद		
						
ओपरेशन्	आङ्ग्लभाषा	अभियान,	operation	ऑपरेशन, ओपरेशन		
ओहदा	अरबी	पद, पदवी, स्थान,				
ओहदेदार	अरबी+फारसी	पदाधिकारी				
						
ऐज़न	अरबी	उपर्युक्त				
ऐज़ाज़	अरबी	आदर, प्रतिष्ठा, सम्मान,				
ऐतबार	अरबी	विश्वास		एतबार , ऐतेबार		
ऐनक	अरबी	उपनेत्र				
ऐब	अरबी	दुर्गुण, दोष, त्रुटि,		ऐबों		
ऐबदार	अरबी+फारसी	दोषयुक्त, दूषित,				
ऐबी	अरबी	अधम, दुष्ट,				
ऐयार	अरबी	धूर्त, चालाक, छली,				
ऐयारी	अरबी	धूर्तता, चालाकी,				
ऐयाश	अरबी	कामुक, विषयी, व्यभिचारी,				
ऐयाशी	अरबी	विलासिता, भोग-विलास, कामुकता, लंपटता, विषयासक्ति,				
ऐरालू	अरबी	???				
ऐश	अरबी	विषयवासना, सुख,				
ऐशगाह	अरबी	विलासभवन,				
ऐशोइशरत	अरबी	समृद्धि ,				
						
औकात	अरबी	शक्ति, सामर्थ्य, पौरुष, योग्यता		ओकात		
औज़ार	अरबी	उपकरण				
औरत	अरबी	[मूल अर्थ: जननांग, नग्नता] स्त्री, नारी, महिला		औरते, औरतें, औरतों, औरतो		
औलाद	अरबी	सन्तान, वंशज		औलादें, औलादे, औलादो, औलादों		
औलिया	अरबी	???				
औसत	अरबी	माध्य, मध्यमान, मध्यम, सामान्य, साधारण				
औसतन	अरबी	सामान्यतः, लगभग				
औसान	फारसी	संज्ञा, बुद्धि,				
औसाफ़	अरबी	गुण				
						
ओटो	आङ्ग्लभाषा	स्वतः, ???	auto	ऑटो		
ओफिस्	आङ्ग्लभाषा	कार्यालय	office	ऑफिस, ओफिस		
ओफिसर्	आङ्ग्लभाषा	अधिकारी	officer	ऑफिसर, ओफिसर		
						
क्योर्	आङ्ग्लभाषा	शम, उपचार, स्वस्थ	cure	क्योर		
क्रैकर्	आङ्ग्लभाषा	पटाखा	cracker	क्रैकर, 		
क्रैकर्स्	आङ्ग्लभाषा	पटाखे	crackers	क्रैकर्स		
क्लास्	आङ्ग्लभाषा	वर्ग	class	क्लास		
क्लिनिक् 	आङ्ग्लभाषा	चिकित्सालय, रुग्णालय, 	clinic	क्लिनिक		
क्लियर्	आङ्ग्लभाषा	स्पष्ट, उत्तीर्ण,	clear	क्लियर		
कँगूरा	फारसी	शिखर, चोटी,				
कंघीसाज़	फारसी	???				कंघी बनाने वाला कारीगर
कचकोल	फारसी	भिक्षापात्र				
कज्ज़ाक	तुर्की	लुटेरा, डाकू		कजाक		
कज्ज़ाकी	तुर्की	लूट, कपट, छल,				
कज़ा	अरबी	मृत्यु, न्याय, आदेश, भाग्य,				
कज़िया	अरबी	विवाद,				
कत्ल	अरबी	हत्या, वध, संहार			^कत(्)?ल$	
कत्लगाह	अरबी+फारसी	वधस्थल			^कत(्)?लगाह$	
क़त्लेआम	अरबी+फारसी	नरसंहार, हत्याकाण्ड			^कत(्)?लेआम$	
कतई	अरबी	कदापि, पूर्ण				
कतरा	अरबी	बून्द	قَطْرَة			
कता	अरबी	बनावट, शैली, आकार,				
कतार	अरबी	पङ्क्ति		कतारों, कतारें		
कद्दू	फारसी	???				लौकी की तरह का प्रसिद्ध गोल फल जिसकी सब्ज़ी बनती है
कद्दूकश	फारसी	???				1. एक उपकरण जिससे कद्दू आदि के छोटे-छोटे लच्छे बनाते हैं 2. कद्दू कसने, घिसने का एक उपकरण।
कदम	अरबी	डग, पग, पैर, सोपान		कदमों		
कदमबोसी	अरबी	चरणस्पर्श				
कदर	अरबी	प्रकार, मान, सम्मान, महत्व, प्रतिष्ठा		कद्र		
कदरदान	अरबी+फारसी	???		कदरदाँ, कद्रदान, कद्रदाँ		
कदीम	अरबी	अनादि, पुरातन, प्राचीन,				
कदीमी	अरबी	प्राचीन, पारंपरिक, पुरातन,				
कदीर	अरबी	शक्तिशाली, बलवान, समर्थ,				
कदूरत	अरबी	मैलापन, दुर्भाव, वैमनस्य,				
कंट्रोल्	आङ्ग्लभाषा	नियन्त्रण	control	कंट्रोल, कन्ट्रोल, कण्ट्रोल		
कंटेंट्	आङ्ग्लभाषा	वस्तु , सामग्री , संतोष,  तृप्ति, 	content	कंटेंट, कण्टेण्ट, कन्टेन्ट, 	^क(ो|ॉ)?(न्|ं|ण्)टे(न्|ं|ण्)ट(्)?$	
कंटेनर्	आङ्ग्लभाषा	पात्र 	container	कंटेनर, कन्टेनर, कण्टेनर		
कन्फ्यूज्ड्	आङ्ग्लभाषा	विमूढ	confused	कन्फ्यूज्ड		
कन्फ्यूज	आङ्ग्लभाषा	भ्रमित 	confuse	कंफ्यूज		
कन्फ्यूजन्	आङ्ग्लभाषा	भ्रम, भ्रान्ति,	confusion 	कन्फ्यूजन		
कन्वर्जन्	आङ्ग्लभाषा	परिवर्तन, मतान्तरण, रूपान्तरण	conversion 	कन्वर्जन, कन्वर्शन,  		
कन्वर्ट्	आङ्ग्लभाषा	परिवर्तित, मतान्तरित, रूपान्तरित	convert	कन्वर्ट		
कन्वर्टेड्	आङ्ग्लभाषा	परिवर्तित, मतान्तरित, रूपान्तरित	converted	कन्वर्टेड		
कनीज	फारसी	परिचारिका, सेविका,				
कनेक्शन	आङ्ग्लभाषा	जोड, सम्पर्क, सम्बन्ध, संयोजन, योग, 	connection 		^कनेक्शन(्|्स्|्स)?$	
कप्तान्	आङ्ग्लभाषा	नायक, नेता,  अध्यक्ष, सैन्याध्यक्ष, नौपति, व्यूहपति, 	captain 	कप्तान		
कफन्	अरबी	शववस्त्र		कफन		
कफ़नखसोट	अरबी	लोभी				
कफ़नी	अरबी	???				
कफ़स	अरबी	पिंजरा, देह, शरीर,				
कब्ज़	अरबी	अधिकार, अवरोध, पकड़, कोष्ठबद्धता, अजीर्ण, मलावरोध				
क़ब्ज़ा	अरबी	अधिकार, नियन्त्रण		कब्जे, कब्जाने , कब्जाके		
कब्ज़ियत	अरबी	कोष्ठबद्धता, मलावरोध,				
कब्ज़ुलवसूल	अरबी	प्राप्तिपत्र				
कब्र	अरबी	समाधि				
कब्रगाह	अरबी	समाधि स्थल , समाधिस्थान				
कब्रस्तान	अरबी+संस्कृत	समाधिस्थान, श्मशान		कबरिस्तान, कब्रिस्तान		
कबा	अरबी	???				
कबाब	अरबी	मांस				
कबाबी	अरबी	मांसाहारी				
कबायली	अरबी	???				
कबाला	अरबी	विक्रयपत्र, अधिकारपत्र,				
कबाहत	अरबी	अनिष्ट, आपत्ति, कठिनता,				
कबीर	अरबी	श्रेष्ठ, उत्तम, महान, सम्मानित,				
कबील	अरबी	समुदाय, जाति, वर्ग,				
कबीला	अरबी	जनजातीय समूह, कुटुंब,			^कब(ि|ी)ल(ा|े|ें|ेँ|ो|ों|ोँ)$	
कबूद	फारसी	नीला, नीलवर्ण,				
कबूल	अरबी	स्वीकार		कुबूल		
कबूलना	अरबी	स्वीकार करना, मान लेना				
कबूलनामा	अरबी	स्वीकृति		कबूलनामे		
कबूलसूरत	अरबी	सुमुख, लावण्यानन, प्रियदर्शन,				
कबूला	अरबी	स्वीकारा				
कबूलियत	अरबी	स्वीकृति,				
कब्र	अरबी	???		कब्रों, कब्रो,		
कब्रिस्तान	अरबी+फारसी	श्मशान				
कम्पनी 	आङ्ग्लभाषा	संगठन, मण्डली, संगत, सभा, जनसमूह, 	company			
कम्पेर्	आङ्ग्लभाषा	तुलना	compare	कम्पेयर, कम्पेर		
कम	फारसी	अल्प, न्यून, थोड़ा, किञ्चित्, क्षीण				
कमाण्डर्	आङ्ग्लभाषा	अधिकारी, आज्ञापक, अधिपति, अधिष्ठाता, 	commander 	कमांडर		
कमाल	अरबी	अद्भुत, सर्वोत्तम, सम्पूर्ण, अतिशय				
कमालियत	अरबी	दक्षता, पूर्णता,				
कमजोर	फारसी	निर्बल, दुर्बल, शक्तिहीन, असमर्थ				
कमजोरी	फारसी	निर्बलता, दुर्बलता, दौर्बल्य, अबल, अशक्ति				
कमतर	फारसी	अल्पतर, न्यूनतर, लघुतर				
कमंगर	फारसी	चित्रकार , ???				
कमंगरी	फारसी	चित्रकारी, कार्यकुशलता,				कमान या धनुष बनाने वाला कारीगर; कमानसाज़ 2. खिसकी हुई हड्डियों को बैठाने वाला 3. चित्रकार; चितेरा; मुसौवर
कमंचा	फारसी					कमान बनाने का पेशा या हुनर 2. खिसकी हुई हड्डियों को बैठाने का काम 3. चित्रकारी; मुसौवरी 4. कार्यकुशलता; कारीगरी
कमबख्त	फारसी	दुर्भाग्य, अभागा, मंदभाग्य		कम्बख्त, कम्बखत		बढ़ई के कमान की तरह का एक टेढ़ा औज़ार जिसमें बँधी रस्सी को बरमे में लपेटकर घुमाया जाता है।
कमान	आङ्ग्लभाषा	नियन्त्रण, आदेश				
कमी	फारसी	अभाव, अवगुण		कमियाँ, कमियां, कमियों		
कमीज़	अरबी	???				
कमीन	अरबी	घात				
कमीना	फारसी	दुष्ट, अधम, निकृष्ट				
कमीशन्	आङ्ग्लभाषा	आयोग, नियुक्ती, शुल्क, 	commission 	कमीशन		
कमिश्नर्	आङ्ग्लभाषा	नियोगी, नियुक्त, अधिकारी, 	commissioner	कमीश्नर, कमीशनर, कमीश्नर्, कमिशनर, 		
कमून	अरबी	जीरा				
कमेन्ट्	आङ्ग्लभाषा	टीका, टिप्पणी, 	comment	कमेंट, कमेंट्स, कॉमेंट, कॉमेंट्स, कमेन्ट, 		
कय्यूम	अरबी	स्थायी, दृढ़, पक्का,				
कयाम	अरबी	ठहराव, निश्चय, स्थिरता,				
कयामत	अरबी	प्रलय, विपत्ति,				
कयास	अरबी	अनुमान, कल्पना, ध्यान,				
कयासी	अरबी	अनुमानित, काल्पनिक,				
कर्ज़	अरबी	ऋण		कर्जा,		
कर्ज़ख़्वाह	अरबी	ऋणेच्छुक				
कर्जदार	अरबी	ऋणी				
कराबत	अरबी	समीपता, संबंध,				
करामत	अरबी	प्रतिष्ठा, महत्ता, अनुग्रह, कृपा, चमत्कार, सिद्धि,				
करामात	अरबी	चमत्कार, सिद्धि , अचरज,				
करामाती	अरबी	ऐंद्रजालिक, सिद्ध, चमत्कारी,		करामती		
करार	अरबी	प्रतिज्ञा, धैर्य, स्थिरता , संतोष,				
करारा	अरबी+फारसी	कठोर				
करारी	अरबी+फारसी	कठोर				
करावल	तुर्की	अश्वारोही				
कराहत	अरबी	घृणा,				
करीन	अरबी	संगत, समान, तुल्य,				
करीना	अरबी	क्रम, ढंग, समानता				
करिश्मा	फारसी	चमत्कार				
करीब	अरबी	समीप, निकट, लगभग				
करीबी	अरबी	संबंधी, समीपवर्ती				
करीम	अरबी	कृपालु, दयालु, उदार, क्षमाशील,				
कल्ब	अरबी	हृदय, मन				
कल्बी	अरबी	हार्दिक				
कलई	अरबी	लेप, मिथ्यावरण,				
कलक	अरबी	दुख				
कलगा	तुर्की	जटाधारी				
कलगी	तुर्की	गुच्छा, चोटी, शिखर, शिखा,				
कलंदर	अरबी	???				
कलंदरी	अरबी	???				
कलफ़	अरबी	???				
कलमा	अरबी	???				
कलाबत्तू	तुर्की	???				
कलाम	अरबी	वाक्य, कथन, वाणी, वचन, प्रतिज्ञा,		कलामे		
कलामुल्लाह	अरबी	अल्लाह का वाक्य				
कलिया	अरबी	मांस				
कलीसा	ग्रीक	गिरजाघर				
कलीम	अरबी	वक्ता				
कलीमुल्लाह	अरबी	अल्लाह से बात करने वाला				
क़लील	अरबी	थोड़ा, छोटा, तनिक, अलप, न्यून, ह्रस्व				
कव्वाल	अरबी	गायक				
कव्वाली	अरबी	गीत				
कवाम	अरबी	रस				
क़वायद	अरबी	नियमावली, कार्यविधि, सैन्यव्यायाम				
कवेला	अरबी	???				
कश्का	अरबी	तिलक				
कश्ती	फारसी	नौका, नाव, नैया		कश्तियाँ, कस्ती, कश्तिया, कश्तियां		
कशमकश	फारसी	दुविधा, असमञ्जस		कश्मकश		
कशिश	फारसी	आकर्षण, वैमनस्य				
कस्द	अरबी	संकल्प, निश्चय, कामना, इच्छा,				
कस्दन	अरबी	निश्चयपूर्वक				
कस्बा	अरबी	गाँव				
कस्साब	अरबी	मांसविक्रेता,				
कसब	अरबी	कौशल, परिश्रम, व्यवसाय, अर्जन, वेश्यावृत्ति,				
कसबाती	अरबी	नगरवासी, नागरिक,				
कसबी	अरबी	वेश्या				
कसम	अरबी	प्रतिज्ञा, शपथ,		कसमें,		
कसर	अरबी	अभाव, त्रुटि, न्यूनता, दोष				
कसरत	अरबी	व्यायाम				
कसरती	अरबी	???				
कसाई	अरबी	निर्दय, निष्ठुर,				
कसाफ़त	अरबी	मैलाप, स्थूलता				
कसाबा	अरबी	???				
कसालत	अरबी	आलस्य, शैथिल्य, थकावट, अनुत्साह,				
कसीदा	अरबी	गुणगान, आकृष्ट, अप्रसन्न,		कसीदे		
कसीर	अरबी	प्रचुर				
क़सूर	अरबी	दोष, अपराध, भूल		क़ुसूर		
कसूरवार	अरबी+फारसी	अपराधी, दोषी,		क़ुसूरवार		
क़हर	अरबी	सङ्कट, आपत्ति				
कागज	फारसी	पत्र, कार्पास, कार्पासिकपत्र				
कागज़ात	अरबी	???				
कागज़ी	अरबी	अव्यावहारिक, औपचारिक,				
काज़ी	अरबी	न्यायकर्ता मौलवी				
कातिब	अरबी	लेखक, लिपिक,				
कातिल	अरबी	हत्यारा		कातिलों		
कातिलाना	अरबी+फारसी	प्राणघातक				
कानून	अरबी	विधान, अधिनियम	قانون	कानूनो, कानूनों		
कानूनन	अरबी	नियमतः, नियमानुसार,				
कानूनी	अरबी	वैध, वैधानिक, न्यायसङ्गत				
काफ़िया	अरबी	अंत्यानुप्रास				
काफ़िर	अरबी	महम्मदवाद को न मानाने वाला				
काफ़िरी	अरबी	???				
क़ाफ़िला	अरबी	सार्थवाह, रक्षक दल		काफिले		
काफ़ी	अरबी	पर्याप्त, बहुत				
काबिज	अरबी	अधिकारी				
काबिल	अरबी	योग्य, समर्थ, विद्वान्		काबील		
काबिलियत	अरबी	योग्यता, सामर्थ्य				
काबिलेतारीफ़	अरबी	प्रशंसनीय				
काबीना	अरबी	मंत्रिमंडल, मंत्रिपरिषद,				
काबू	तुर्की	वश, नियन्त्रण, अधिकार,				
काबूची	तुर्की	द्वारपाल, स्वार्थी				
कामत	अरबी	आकार, शरीर,				
क़ामयाब	फारसी	सफल				
कामयाबी	फारसी	सफलता, सिद्धि, चरितार्थता, सिद्धार्थता, कृतार्थता		कामयाबियां		
कामिल	अरबी	पूर्ण, संपूर्ण, सब, कुल, दक्ष, निपुण,				
कायज़ा	अरबी	???				
क़ायदा	अरबी	नियम, विधान		कायदे, कायदों		
कायदेआज़म	अरबी	महानायक				
क़ायनात	अरबी	ब्रह्माण्ड				
क़ायम	अरबी	स्थिर, स्थायी				
कायममिज़ाज	अरबी	स्थिरचित्त				
कायल	अरबी	प्रशंसक,				
कारूती	अरबी	???				
कारूरा	अरबी	मूत्र				
कारोबार	फारसी	कार्य-व्यापार, उपक्रम, उद्योग				
कारोबारी	फारसी	व्यापारी, उद्योगी				
कालाबाजार	उर्दू	???				
कालाबाजारी	उर्दू	???				
कालिब	अरबी	शरीर, देह,				
काश	फारसी	इच्छा, आशा, सम्भवतः, कदाचित				
कासा	फारसी	कटोरा				
कासिद	अरबी	अप्रचलित, पत्रवाहक, दूत,				
कासिम	अरबी	वितरक, विभाजक, विभाजनकर्ता,				
कासिर	अरबी	त्रुटि, अक्षम, असमर्थ,				
काहिर	अरबी	विजयी, विजेता, अत्याचारी,				
काहिल	अरबी	कामचोर, आलसी, मंद,				
काहिली	अरबी	आलस्य, शैथिल्य, कामचोरी,				
किडनी	आङ्ग्लभाषा	बृक्क, मूत्रपिण्ड,	kidney 			
किडनैप	आङ्ग्लभाषा	अपहरण, हरण, 	kidnap			
किडनैपिंग	आङ्ग्लभाषा	अपहरण, हरण, 	kidnapping 			
किता	अरबी	टुकड़ा, खंड,				
किताब	अरबी	पुस्तक		किताबे, किताबें, किताबों, किताबो		
किताबत	अरबी	लेखन				
किताबी	अरबी	पुस्तकीय				
किंग	आङ्ग्लभाषा	राजा, नरेश, भूपति, 	king	किंग्स 		
किनारा	फारसी	तट				
किफ़ायत	अरबी	मितव्यय				
किफ़ायती	अरबी+फारसी	मितव्ययी, लाभप्रद				
किमाम	अरबी	गाढरस				
किमार	अरबी	जुआ, द्यूत, द्यूतक्रीडा,				
किमाश	अरबी	ढंग, नियम,				
किरदार	फारसी	चारित्र, स्वाभाव, वृत्ति, भूमिका		किर्दार, कर्दार		
किरमिज़	अरबी	???				
किरमिज़ी	अरबी	???				एक प्रकार का मटमैला लाल रंग 2. मटमैले रंग का घोड़ा 3. किरिमदाने का चूर्ण; बुकनी किया हुआ किरिमदाना।
किरात	अरबी	???				किरमिज़ के रंगवाला 2. मटमैले लाल रंगवाला।
किराया	अरबी	भाड़ा		किराये, किराए		
किरायेदार	फारसी	अधिवासी, परस्वामिकक्षेत्राधिवासी		किराएदार		
किरावल	तुर्की	???				
क़िल्लत	अरबी	अभाव, दुर्लभता, न्यूनता				1. सेना की वह टुकड़ी जो सेना के आगे-आगे चलती है तथा शत्रु सेना के आगमन की टोह लेती है 2. वह सैन्य टुकड़ी जो युद्ध का मैदान साफ़ करने के लिए सेना के आगे-आगे जाती है 3. बंदूक से शिकार खेलने वाला शिकारी 4. दूसरों को शिकार खिलाने वाला व्यक्ति।
क़िला	अरबी	गढ, दुर्ग		किल्ला, किल्ले, किले, कीलें		
किलिंग्	आङ्ग्लभाषा	हत्या, वध, 	 killing	किलिंग		
किस्त	अरबी	अंश, भाग, खंड, टुकड़ा,				
क़िस्म	अरबी	प्रकार, वर्ग, जाति, कोटि ,		किसम		
किस्मत	अरबी	भाग्य		किस्मतों		
किस्मतआज़माई	अरबी	भाग्यपरीक्षा				
किस्सा	अरबी	कथा, घटना, वार्ता		किस्से, किस्सों,  		
किसबत	अरबी	???				
क़ीमत	अरबी	मूल्य, प्रतिष्ठा, योग्यता		किमत		कई खानों वाली वह थैली जिसमें नाई अपने औज़ार रखते हैं।
कीमती	अरबी	मूल्यवान, महत्वपूर्ण		किमती		
कीमा	अरबी	मांस के टुकड़े				
कीमिया	अरबी	रसायनविद्या, रासायनिक क्रिया, रसायन, युक्ति,				
कुतबा	अरबी	लेख, आलेख,				
कुतुब	अरबी	पुस्तके, ध्रुवतारा,				
कुदरत	अरबी	प्रकृति				
कुदरती	अरबी	प्राकृतिक, स्वाभाविक, नैसर्गिक				
कुर्क	तुर्की	???		कुर्की		
कुर्ता	तुर्की	चोला		कुरता		
कुर्ती	तुर्की	चोली		कुरती		पूरी या आधी बाँहोंवाला बिना कॉलर का एक ढीला-ढाला परिधान जो शरीर के ऊपरी भाग को ढकता है; एक प्रकार की कमीज़।
कुर्बान	अरबी	बलि, त्याग, समर्पित		कुरबान		
कुर्बानी	अरबी	बलिदान, त्याग, समर्पण		क़ुरबानी		
कुमक	तुर्की	सैन्य आपूर्ति, अनुपूर्ति, सहायता,		कुमुक		
कुर्सी	अरबी	आसन, सत्ता		कुर्सियां , कुर्सियाँ , कुर्सीया		
कुलाँच	तुर्की	उछाल, छलांग,				
कुली	तुर्की	सेवक,				
केपिटल्	आङ्ग्लभाषा	राजधानी	capital 	कैपिटल, केपिटल		
केपेसिटी	आङ्ग्लभाषा	क्षमता	capacity 	कपैसिटी, कैपेसिटी		
केयर	आङ्ग्लभाषा	देखभाल, सावधानी, चिन्ता	care			
कुश्ती	फारसी	मल्लयुद्ध				
केटेगरी	आङ्ग्लभाषा	कोटि, श्रेणी, वर्ग,  	category 	कैटेगरी, कैटिगरी		
कोकई	तुर्की	???				
कोचिंग्	आङ्ग्लभाषा	प्रशिक्षण, 	coaching 	कोचिंग		
कोंफ्रेंस्	आङ्ग्लभाषा	सम्मेलन, सभा, परिषद, मन्त्रणा, 	conference 		^क(ो|ॉ)(न्|ं)फ्रे(न्|ं)स(्)?$	
कोन्सेप्ट्	आङ्ग्लभाषा	संकल्पना, सिद्धान्त, परिकल्पना, संप्रत्यय, धारणा,	concept 	कॉन्सेप्ट, कोन्सेप्ट, कांसेप्ट, 		
कोम्प्लेक्स्	आङ्ग्लभाषा	जटिल, मिश्रित, मनोग्रन्थि, भवनसमूह, 	complex	काम्प्लेक्स , कॉम्प्लेक्स, कॉम्पलेक्स		
कोमन्	आङ्ग्लभाषा	सामान्य, साधारण, समान,	common 	कॉमन, कोमन		
कोर्ट्	आङ्ग्लभाषा	न्यायालय	court	कोर्ट		
कोर्नर्	आङ्ग्लभाषा	कोण	corner	कोर्नर, कॉर्नर, कॉर्नर्स		
कोर्स्	आङ्ग्लभाषा	पाठ्यक्रम , मार्ग, प्रवाह, अध्ययनक्रम, 	course 	कोर्स	^क(ो|ॉ)र्स(्)?$	
कोरनिश	तुर्की	???				
कोरमा	तुर्की	???				दरबारी तहज़ीब के मुताबिक़ झुककर सलाम या बंदगी करना।
कोरिडोर्	आङ्ग्लभाषा	छन्नपथ, गलियारा 	corridor 	कॉरिडोर, कोरिडोर		
कोलेज्	आङ्ग्लभाषा	महाविद्यालय, विद्यापीठ	college 	कॉलेजो, कॉलेजों, कॉलेज		
कोशिश	फारसी	प्रयत्न, प्रयास		कोशिशें, कोशिशे, कोशिशों, कोशिशो, कोसिस		
कैंची	तुर्की	कर्त्तरी		कैंचा		
क़ैद	अरबी	बन्ध, बन्धन, कारावास				
कैदखाना	अरबी+फारसी	कारावास, कारागृह, बन्धनगार, 		कैदखाने		
कैदी	अरबी+फारसी	कारास्थ, बंदी, युद्धधृत		कैदियों		
कैरेक्टर्	आङ्ग्लभाषा	शील, चरित्र, स्वभाव, भूमिका, अक्षर, वर्ण, लक्षण, 	character	कैरेक्टर, कैरेक्टर्स		
कैलेंडर्	आङ्ग्लभाषा	पञ्चाङ्ग, तिथि-पत्र, दिनदर्शिका	calendar 	कैलेंडर		
कौम	अरबी	जाति, वंश				
						
ख़्वाजासरा	तुर्की	???				
ख्वाब	फारसी	स्वप्न		ख्वाबों, ख्वाबो, ख्ह्वाब, ख्ह्वाबो, ख्ह्वाबों		1. पुराने समय में रनिवास का हिजड़ा नौकर 2. शाही महल में अंतःपुर का दरोगा जो प्रायः नपुंसक हुआ करता था।
ख्वाहिश	फारसी	आकांक्षा, अभिलाषा, महत्त्वाकांक्षा		ख्वाहिशें, ख्वाहिशे, ख्वाहिशों, ख्वाहिशो, ख्वाईश, ख्वाइश, ख्वाइशें, ख्वाईस,		
खजाना	अरबी	कोष, धनराशि, निधि, द्रव्यसञ्चय		खजाने		
ख़जालत	अरबी	लज्जा, सङ्कोच, पश्चाताप				
खत्म	अरबी	समाप्त, नष्ट		ख़तम		
ख़त	अरबी	पत्र				
खतकिताबत	अरबी	पत्रव्यवहार				
खतरनाक	अरबी+फारसी	भयानक, भयजनक, भयावह				
खतरा	अरबी	भय, डर, सङ्कट, जोखिम		खतरे, खतरें, खतरों		
खता	अरबी	अपराध, भूल, दोष				
ख़ंजर	अरबी	कटार, छुरी				
खंद	???	???				
खफ़ा	फारसी	अप्रसन्न, असन्तुष्ट				
ख़बर	अरबी	जानकारी, ज्ञान, समाचार		खबरें, ख़बरों, खबरिया, खबरे, खबरो		
खबरदार	अरबी	सावधान, सचेत				
खयाल	अरबी	ध्यान, विचार		ख्याल, ख़यालों, ख्यालों		
खर्च	फारसी	व्यय, लागत		खर्चा, खर्चो, खर्चे, खरच		
ख़रगोश	फारसी	शशक				
खराब	अरबी	अशुभ, दूषित, दोषपूर्ण, दोषयुक्त, अवगुणयुक्‍त				
खराबी	अरबी	दोष, त्रुटि, अवगुण				
ख़रीद	फारसी	क्रय, मोल		खरीदी , खरीदारी, खरीदो , खरीदा, खरीदूंगा, खरीदूंगी, खरीदेंगे, खरीदने , खरीदकर, खरीदना, खरीदके , खरीदें, खरिदनी, खरीदनी,		
खल्क	अरबी	संसार, जगत		खलक		
खलल	अरबी	अवरोध, विघ्न, बाधा				
खलिश	फारसी	चिन्ता, पीडा				
खस्ताहाल	फारसी	दुर्दशाग्रस्त, दरिद्र				
खाक	फारसी	धूल, मिट्टी, राख				
ख़ाक़ान	तुर्की	सम्राट, राजा,				
खात्मा	अरबी	समाप्ति, अन्त		खात्मे		
ख़ातून	तुर्की	श्रीमती				
खातिर	अरबी	कारण, हेतु, प्रयोजन				
खातिरदारी	अरबी+फारसी	सत्कार, सम्मान				
खानकाह	अरबी	मठ, आश्रम, 				
ख़ानख़ानान	तुर्की	सेनापति				
खानदान	फारसी	कुल, वंश, कुटुम्ब				
खानदानी	फारसी	पैतृक, कुलीन				
ख़ामख़ाह	फारसी	व्यर्थ, मिथ्या		ख्वाह-म-ख्वाह, खामखा, खामखां		
खामियाजा	फारसी	दुष्परिणाम				
खामोश	फारसी	मौन, मूक, तूष्णीक, चुप				
खामोशी	फारसी	चुप्पी, मौन				
ख़ारिज	अरबी	अस्वीकृत				
खाविंद	फारसी	पति		खाविन्द, खावींद		
ख़ास	अरबी	विशेष	خاص			
खासकर	अरबी	विशेषतः, विशेष रूप से				
खासतौर	अरबी	विशेषतः, विशेष रूप से				
खासियत	अरबी	विशेषता		खासियतें		
ख़िज़ाँ	फारसी	पतन, पतझड़, वृद्धावस्था		ख़ज़ां		
ख़िताब	अरबी	पुरस्कार, पदवी				
ख़िदमत	अरबी	सेवा, सत्कार				
खिदमतगार	अरबी	सेलक				
खिराज	अरबी	राजस्व 				
ख़िल्क़त	अरबी	सृष्टि, जनसमूह, संसार		ख़िलकत, ख़ल्कत		
ख़िलाफ़	अरबी	विरुद्ध				
ख़ुत्बा	अरबी	इस्लामी उपदेश				
खुद्दार	फारसी	स्वाभिमानी		खुददार		
खुद्दारी	फारसी	स्वाभिमान		खुददारी		
खुद	फारसी	स्वयं, साक्षात		खुदको, खूद, khud, Khud		
खुदगर्ज	फारसी	स्वार्थी, स्वार्थपरायण, स्वार्थनिष्ठ		खुदगर्जो		
खुदगर्जी	फारसी	स्वार्थ				
खुदा	फारसी	अल्लाह				
खुदी	फारसी	अहङ्कार, गर्व, घमण्ड				
खुफिया	फारसी	गुप्त				
खुबानी	फारसी	???				
खुमार	अरबी	मद				
खुर्रम	फारसी	प्रसन्नचित्त, आनन्दित, हर्षित				
खुलेआम	हिन्दी+अरबी	प्रत्यक्ष रूप से				
खुश	फारसी	प्रसन्न				
खुशकिस्मत	फारसी+अरबी	भाग्यवान, सौभाग्यशाली, भाग्यशाली				
खुशखबर	अरबी+फारसी	शुभ समाचार		ख़ुशख़बरी		
खुशनसीब	अरबी+फारसी	भाग्यवान, सौभाग्यशाली, भाग्यशाली				
खुशनुमा	फारसी	सुन्दर, मोहक, मनोहर				
खुशबु	फारसी	सुगन्ध		खुशबू, खूशबु, खूशबू, खुश्बु,खुश्बू, खूश्बु, खूश्बू		
खुशबूदार	फारसी	सुगन्धित				
खुशमिज़ाज	फारसी	हँसमुख, प्रसन्नचित				
खुशहाल	अरबी+फारसी	सुखी, प्रसन्न, आनन्दित, सौभाग्यशाली				
खुशहाली	अरबी+फारसी	हर्षोल्लास, आनन्द, प्रसन्नता, समृद्धि				
खुशी	फारसी	आनन्द, प्रसन्नता, हर्ष, हर्षोल्लास		खुशियां, खुशियाँ, खुशियों		
खूंखार	फारसी	हिंसक, क्रूर, निर्दयी		खूँख़ार		
खून	फारसी	रक्त, हत्या, वध, लहू		खुन		
खूनखराबा	फारसी+अरबी	रक्तपात, हिंसा, मारकाट		खूनखराबे		
खूनी	फारसी	हत्यारा, रक्तरञ्जित, हिंसक				
खूब	फारसी	अच्छा, उत्तम, अधिक, बहुत	خوب	खुब		
खूबसूरत	अरबी+फारसी	सुन्दर, आकर्षक, अतिसुन्दर, दर्शनीय, रमणीय		खुबसूरत, खुबसुरत, खूबसुरत		
खूबसूरती	अरबी+फारसी	सुन्दरता, रमणीयता,		खुबसूरती, खुबसुरती, खूबसुरती		
खूबी	फारसी	विशेषता		खूबियां, खूबियाँ, खुबी,खुबीयां, खुबीयाँ		
खैर	???	अच्छा				
खैरकदम	अरबी	स्वागत				
खैरात	अरबी	दान, उपकार, सहायता				
ख़ैरियत	अरबी	भलाई				
खौफ	अरबी	भय, डर				
ख़ौफ़नाक	अरबी	डरावना, भयानक				
						
ग्रुप्	आङ्ग्लभाषा	समूह	group	ग्रुप		
ग्लोबल्	आङ्ग्लभाषा	वैश्विक , भूमंडलीय,  	global	ग्लोबल		
गजल	अरबी	???				
गजब	अरबी	अद्भुत, आश्चर्यजनक, आश्चर्यकारक, विस्मयकारी		गज्जब		
गजवा	अरबी	इस्लाम को न मानने वालों के ऊपर आक्रमण	غَزْوَة			
गद्दार	अरबी	राष्ट्रद्रोही, देशद्रोही, विद्रोही		गद्दारों, गद्दारो		https://en.m.wiktionary.org/wiki/ghazwa#:~:text=A%20battle%20or%20raid%20against,of%20non%2DMuslims%20to%20Islam.
ग़द्दारी	अरबी+फारसी	द्रोह				
गंजीफा	फारसी	???				
गंदगी	फारसी	मलिनता, अपवित्रता, अशुद्धि		गन्दगी		
गंदा	फारसी	मलिन, अशुद्ध, अश्लील		गंदी, गन्दी		
गनीमत	अरबी	पुरस्कार				
ग़म	अरबी	दुःख, शोक, चिन्ता		ग़मों, ग़मो		
गमगीन	अरबी+फारसी	दुःखी, चिन्तित, उदास, विरक्त				
गमजदा	अरबी+फारसी	दुःखी				
गर्द	फारसी	धूल, रज				
गर्दिश	फारसी	दुर्भाग्य, भ्रमण, कालचक्र				
गर्म	फारसी	उष्ण		गरम		
गर्मी	फारसी	उष्णता, ताप, ग्रीष्म ऋतु		गरमी, गर्मियों		
गर्ल्	आङ्ग्लभाषा	कन्या, कुमारी, तरुणी, बाला, बालिका, पुत्री, लडकी, 	girl		^गर्ल(्)?(स्|स)?$	
गरदन	फारसी	गला, ग्रीवा		गर्दन		
गराँ	???	???				
गरीब	अरबी	दरिद्र, निर्धन		गरीबों, गरीबो, गरिब		
गरीबनवाज	अरबी+फारसी	दीनदयाल, दीनवत्सल		गरीब-नवाज		
गरीबी	अरबी	दरिद्रता, निर्धनता				
गलत	अरबी	अनुचित, असत्य				
गलतफहमी	अरबी+फारसी	भ्रम, भ्रान्ति, मिथ्याबोध		गलतफहमियाँ, गलतफहमियां		
गलती	अरबी+फारसी	दोष, त्रुटि, क्षति		गलतिया, गलतियां, गलतियाँ, गलतियों, गलतियोँ, गलतियो		
गवर्नेंस	आङ्ग्लभाषा	अभिशासन	governance 			
गवारा	फारसी	स्वीकार्य, मान्य		गंवारा		
गवाह	फारसी	साक्षी, प्रत्यक्षदर्शी		गवाहों		
गवाही	फारसी	साक्ष्य, साक्षी, प्रमाण				
गश्त	फारसी	पहरा, भ्रमण				
गायब	अरबी	अदृश्य, लुप्त, अनुपस्थित				
गार्ड्	आङ्ग्लभाषा	रक्षा, रक्षक, 	guard	गार्ड 		
गार्डन्	आङ्ग्लभाषा	उद्यान, वाटिका	garden	गार्डन 		
गिफ्ट्	आङ्ग्लभाषा	उपहार, प्रदान,  	gift	गिफ्ट 		
गिरफ़्त	फारसी	पकड				
गिरफ्तार	फारसी	धरपकड, अवरुद्ध				
गिरफ्तारी	फारसी	धरपकड, अवरुद्ध				
गिरेबान	फारसी	गला, गलपट्टा		गिरेबां, गिरेबाँ, गरेबान, गरेबाँ, गरेबां		
गिला	फारसी	उलाहना, निंदा, उपालम्भ		गिले		
गिलास	आङ्ग्लभाषा	???	glass			
ग्रीन्	आङ्ग्लभाषा	हरा, 	green	ग्रीन		
गुजर	फारसी	मार्ग, निर्वाह,				
गुजरना	फारसी	जाना, निकलना, चलना		गुजरा, गुजरी, गुजरे, गुजरता, गुजरती, गुजरते, गुजरने, गुजरेंगे,गुजरेगी, गुजरेंगे, गुजरेंगे		
गुजारना	फारसी	बिताना, व्यतीत करना		गुजारता, गुजारती, गुजारते, गुजारेगा, गुजारेगी, गुजारेंगे, गुजार		
गुजारिश	फारसी	प्रार्थना, निवेदन, अनुरोध, विनती				
गुनहगार	फारसी	अपराधी, दोषी		गुनाहगार, गुनाहगारों, गुनाहगारो, गुनहगारों, गुनहगारो		
गुनाह	फारसी	अपराध, दोष, भूल, दुष्कर्म, पातक		गुनाहों		
गुफ़्तगू	फारसी	वार्तालाप, बातचीत		गुफ्तुगू		
गुम	फारसी	गुप्त, अदृश्य, अप्रकट, स्थानभ्रष्ट				
गुमनामी	फारसी	नामहीन				
गुमराह	फारसी	पथभ्रष्ट		गुमराहों, गुमराहो,		
गुमशुदा	फारसी	खोया, अनुपलब्ध,				
गुमान	फारसी	अभिमान, अहङ्कार, घमण्ड				
गुरबत	अरबी	विवशता, प्रवास, विदेश, दरीद्रता				
गुरूर	अरबी	अभिमान	غرور	गुरुर		
गुरेज़	फारसी	घृणा, बचना				
गुल	फारसी	पुष्प		गुलों		
गुलजार	फारसी	प्रफुल्लित, पुष्पवाटिका				
गुलदस्ता	फारसी	पुष्पगुच्छ				
गुलाब	फारसी	जवा, जपा, जवापुष्प, ओड्रपुष्प, हेमपुष्प		गुलाबों, गुलाबो		
गुलाम	अरबी	अधीन, चेटक		गुलामों		
गुलामी	अरबी	अधीनता				
गुलिस्ताँ	फारसी	पुष्पवाटिका, फुलवारी		गुलिस्ता, गुलिस्तां, गुलिस्तान		
गुस्ताख	फारसी	धृष्ट, अशिष्ट				
गुस्ताखी	फारसी	धृष्टता, अशिष्टता		गुस्ताखियां , गुस्ताखियाँ, गुस्ताखिया ,		
गुस्सा	अरबी	क्रोध		गुस्से		
गेइम्	आङ्ग्लभाषा	क्रीडा, खेल,  	game	गेम्स 		
गेट	आङ्ग्लभाषा	द्वार	gate			
ग़ैर	अरबी	अन्य		गैरों, गैरो		
गैरकानूनी	अरबी	अवैध				
गैरजिम्मेदार	अरबी	अननुयोगाधीन, अनुत्तरदायी, दायित्वहीन				
गैरजिम्मेदारी	अरबी	अनुत्तरदायित्व				
गैरजिम्मेदाराना	अरबी	अनुत्तरदायित्वपूर्ण				
ग़ौर	अरबी	विचार, चिन्तन, ध्यान				
						
चकमक	तुर्की	अग्निप्रस्तर				
चकला	तुर्की	वेश्यालय				
चंद	फारसी	कुछ, थोड़ा, अल्प, न्यून				
चपकुलिश	तुर्की	झंझट, लड़ाई, झगड़ा,				
चमन	फारसी	वाटिका, पुष्पवाटिका				
चश्म	फारसी	आँख, नयन, नेत्र, चक्षु, लोचन, अम्बक				
चश्मदीद	फारसी	प्रत्यक्षदर्शी				
चश्मा	फारसी	उपनेत्र		चश्में,चश्मे,		
चाक	तुर्की	सतर्क, दृढ़, चुस्त, स्वस्थ				
चाकचौबंद	तुर्की	???				
चाकर	फारसी	सेवक, भृत्य				1. चारों ओर से ठीक एवं दुरुस्त 2. चुस्त; फुरतीला।
चाकू	फारसी	छुरी				
चाकूबाज	फारसी	???				
चाकूबाजी	फारसी	???		चाकूबाजों		
चादर	फारसी	???				
चाबुक	फारसी	कोड़ा, प्रतोद, अंकुश				
चालाक	फारसी	चतुर				
चालाकी	फारसी	चतुराई				
चिक	तुर्की	मांसविक्रेता				
चिकन्	आङ्ग्लभाषा	कुक्कुट	chicken	चिकन		
चीज़	फारसी	वस्तु, पदार्थ, सामग्री, द्रव्य		चीजों		
चुस्त	फारसी	स्फूर्तियुक्त, सशक्त, दृढ़				
चेकर्	आङ्ग्लभाषा	जाँचकर्ता	checker	चेकर, चेकर्स		
चेयरमैन्	आङ्ग्लभाषा	अध्यक्ष, सभापति, सभाध्यक्ष	chairman	चेयरमैन		
चेहरा	फारसी	मुख, मुखड़ा, वदन, आनन		चेहरे, चेहरों, चहरे		
चोगा	तुर्की	चोला				
चौकीदार	हिन्दी+फारसी	पहरी				
चौकीदारी	हिन्दी+फारसी	सुरक्षा, चौकी				
चौतरफ	उर्दू	चारों दिशा मे				
चौतरफा	उर्दू	चारों दिशा से				
चौगिर्द	उर्दू	चारों दिशा से				
						
ज्यादा	अरबी	अधिक, बहु				
ज्यादातर	अरबी	अधिकतम				
जख्म	फारसी	व्रण, क्षति, अरुस्, ईर्म, त्वग्भेद, त्वक्छेद		जख्मों		
जख्मी	फारसी	व्रणित, क्षत, क्षतिग्रस्त, आहत, अभिहत, उपहत, विहत				
ज़ख़ीरा	अरबी	कोष, राशि, भण्डार, सङ्ग्रह, समूह		जखीरे		
जगह	फारसी	स्थान		जगहों, जगहो		
ज़ज्बात	अरबी	भावना, आवेग, उमङ्ग	جَذَبَ	जज्बातों, जजबातों, जजबात, जज्बा, जज्बे		
जज्बाती	अरबी	भावुक, भावात्मक,				
जज	आङ्ग्लभाषा	न्यायाधीश	judge	जजों		
जंग	फारसी	युद्ध		जंगे		
ज़ंजीर	फारसी	साँकल, बेड़ी		जंजीरें		
जन्नत	अरबी	स्वर्ग				
जनाजा	???	अर्थी		जनाजे		
जनाब	अरबी	महाशय, महोदय	جِنَاب			ज
ज़ब्त	अरबी	अधिहृत		जप्त		
जबरदस्त	फारसी	प्रभावी, प्रभावशाली, प्रचंड, शक्तिशाली		जबर्दस्त		
जबरदस्ती	अरबी	बलपूर्वक		जबर्दस्ती, जबरदसती, जबर्दसती		
जबरन	अरबी	बलपूर्वक				
जबान	फारसी	जिह्वा, जीभ, भाषा		जबाँ, जुबान, जबां, जुबाँ, जुबां		
जबानी	फारसी	मौखिक, कथन		जुबानी		
ज़ंबूरक	तुर्की	भँवरकली				
ज़ंबूरची	तुर्की	???				
जमाखोरी	फारसी	???				तोपची।
जमात	अरबी	समुदाय, संघ, कक्षा, श्रेणी		जमातों,		
जमानत	अरबी	निक्षेप, प्रत्याभूति				
जमाना	अरबी	काल, युग, संसार		ज़माने		
जमाल	अरबी	सौन्दर्य, सौम्यता	جمال‎			
ज़मीन	फारसी	पृथ्वी, धरती, भूमि, धरा		जमीनें, जमीने, जमीं, जमीँ		
जमीनदार	फारसी	सामन्त, भूस्वामी		जमींदार		
जमीनी	फारसी	व्यवहारिक, भूमिगत,				
ज़मीर	अरबी	आत्मा, अन्तःकरण				
जमील	अरबी	सुन्दर				
जर्द	फारसी	पीतवर्ण, पीला,				
जर्दगोश	फारसी	धूर्त, छली,				
जर्दचोब	फारसी	हरिद्रा, हल्दी				
जरगा	तुर्की	जनसमुदाय, जनसभा, जनसमूह,				
ज़रिया	अरबी	साधन, मार्ग, माध्यम		जरिए, जरिये		
जरूर	अरबी	अवश्य, निःसन्देह		जरुर		
जरूरी	अरबी	आवश्यक, अनिवार्य		जरुरी		
जरूरत	अरबी	आवश्यकता, प्रयोजन		जरुरत, जरूरतों, जरुरतों, जरूरतें		
जरूरतमंद	अरबी+फारसी	असहाय, अभावग्रस्त		जरूरतमंदों, जरुरतमंदों, जरुरतमंद		
जल्द	अरबी	शीघ्र				
जल्दी	अरबी	शीघ्र				
जलवा	अरबी	प्रतिभा, भव्यता, प्रदर्शन, शोभा, दीप्ति, सौंदर्य, छटा				
जलील	अरबी	अपमानित, तिरस्कृत				
जवान	फारसी	युवान, सैनिक, वयस्क		जवानों , जवाँ		
जवाब	अरबी	उत्तर		जवाबों, जवाबी		
जवाबदार	अरबी+फारसी	उत्तरदायी		जवाबदारों		
जवाबदारी	अरबी+फारसी	उत्तरदायित्व		जवाबदारिया, जवाबदारियां, जवाबदारियाँ		
जवाबदेह	अरबी+हिन्दी	उत्तरदायी				
जवाहर	अरबी	रत्न, मणि				
जश्न	फारसी	उत्सव				
जहन्नुम	अरबी	नर्क				
जहन्नुमी	अरबी	नारकीय, नारकिक, ???				
जहनसीब	अरबी+फारसी	सौभाग्य, अहोभाग्य				
जहनियत	अरबी	बुद्धिमानी		जहनीयत, जेहनियत, जेहनीयत		
जहर	अरबी	विष, हलाहल, गरल, भूगर, जङ्गुल, क्ष्वेड				
ज़हरीली	अरबी	विषाक्त, विषालु, विषमय, गरलिनी, विषैली				
ज़हरीला	अरबी	विषाक्त, विषालु, विषमय, गरली, विषैला		जहरीले		
जहालत	अरबी	मूर्खता, अशिष्टता, असभ्यता, अज्ञान, 				
जहीर	अरबी	साथी, मित्र, सहयोगी, सहायक, 				
जागीर	फारसी	अनुदान				
जाजिम	तुर्की	दरी, मोटीदरी,				
जादू	फारसी	इन्द्रजाल, चमत्कार, हस्तकौशल, प्रभाव				
जादूगर	फारसी	दृष्टिबंधक, ऐंद्रजालिक, मायावी		जादूगारा		
जाँबाज़	फारसी	वीर, साहसी, शूरवीर,		जांबाज		
जाँबाजी	फारसी	वीरता, साहस		जांबाजी		
जान	फारसी	जीवन, प्राण				
जानदार	फारसी	सजीव, प्राणवान, शक्तिशाली				
जानलेवा	फारसी+हिन्दी	प्राणघातक				
जानवर	फारसी	पशु, प्राणी				
जानवरों	फारसी	पशुओं , प्राणीओं				
जायज़	अरबी	उचित, वैध				
जायजा	अरबी	निरिक्षण, अनुमान				
जायदाद	फारसी	संपत्ति				
जारी	अरबी	प्रचलित, लागू, क्रियाशील, नित्य				
ज़ालिम	अरबी	अत्याचारी, क्रूर		जालिमो, जालिमों		
जासूस	अरबी	गुप्तचर		जासूसो, जासूसों		
जासूसी	अरबी	???				
ज़ाहिर	अरबी	प्रकट, ज्ञात, विदित, स्वाभाविक				
जाहिल	अरबी	मूर्ख, अशिष्ट, अशिक्षित, असभ्य		जाहिलों, जाहिलो		
जाहिली	अरबी	मूर्खता, अशिष्टता, असभ्यता,				
ज़िक्र	अरबी	उल्लेख, स्मरण, अभिधान, नामनिर्देश				
ज़िंदगी	फारसी	जीवन		जिन्दगी, जिँदगी, जिन्दगीं, जिंदगियों, जिन्दगियों		
जिंदा	फारसी	जीवित		जिन्दा		
जिंदादिल	फारसी	प्रसन्नचित्त, उत्साही, सहृदय, हँसमुख		जिंदहदिल, जिन्दादिल		
जिंदादिली	फारसी	उत्साह, प्रसन्नता, सहृदयता				
जिंदाबाद	फारसी	चिरञ्जीवी हो		जिन्दाबाद		
ज़िद	अरबी	हठ, दुराग्रह		जिद्द		
ज़िद्दी	अरबी	दुराग्रही				
ज़िम्मा	अरबी	उत्तरदायित्व, कार्यभार				
ज़िम्मेदार	अरबी+फारसी	उत्तरदायी		जिमेदार, जिम्मेवार, जिमेवार		
ज़िम्मेदारी	अरबी+फारसी	उत्तरदायित्व		जिम्मेदारियों, जिम्मेवारी, जिम्मेवारियों, जिम्मेवारियां, जिम्मेदारियां , जिमेदारी, jimmedari, zimmedari		
जिरगा	तुर्की	समूह, मंडली, सभा, पंचायत, सम्मेलन,				
ज़िल्लत	अरबी	अपमान, तिरस्कार, पतन, दुर्दशा				
जिस्म	अरबी	शरीर, देह, तन		जिस्मों		
जिस्मफरोशी	अरबी+फारसी	देहव्यापार, वेश्यावृत्ति, 				
जिहाद	अरबी	इस्लाम के लिए संघर्ष करना	جهاد			
जिहालत	अरबी	अज्ञानता , मूर्खता				
जुकाम	अरबी	प्रतिश्याय, पीनस,				
जुनून	अरबी	उत्साह, आवेश				
जुमला	अरबी	वाक्य, सम्पूर्ण, समस्त				
जुर्म	अरबी	अपराध				
जुर्माना	अरबी+फारसी	दण्ड, अर्थदण्ड		जुरमाना, जुर्माने		
जुर्रत	अरबी	दुस्साहस, धृष्टता				
जुर्राब	तुर्की	पादवस्त्र		जुराब		
जुल्फ	फारसी	केश, बाल, शिरोरुह, मूर्द्धज		जुल्फों, जुल्फो, जुल्फे, जुल्फें		
जुल्म	अरबी	अत्याचार		जुल्मों, जुल्मो		
जुल्मत	अरबी	अन्धकार, तम, तिमिर,				
जुलूस	अरबी	शोभायात्रा, जनयात्रा				
जुस्तजू	फारसी	शोध, अन्वेषण				
जेंडर	आङ्ग्लभाषा	लिङ्ग, जाती	gender			
जेल	आङ्ग्लभाषा	कारागार, कारागृह, बन्धनगार	jail	जैल		
जेवर	फारसी	आभूषण, अलङ्कार, गहना				
जेहन	अरबी	बुद्धि, विवेक, धारणाशक्ति, स्मरणशक्ति		जहन		
जोर	फारसी	बल, शक्ति, प्रभाव				
ज़ोरदार	फारसी	प्रबल, प्रभावशाली, बलशाली				
जोरू	???	पत्नी, भार्या				
जौक	अरबी	स्वाद, आनन्द, रसानुभव, रुचि				
						
ट्रक्	आङ्ग्लभाषा	शकट, क्षुद्रचक्र, नीचचक्र, द्रव्यवाहन, नीचशकट	truck	ट्रक		
ट्रस्टी	आङ्ग्लभाषा	न्यासी, संरक्षक, अभिभावक	trustee	ट्रस्टियों , ट्रस्टियो, ट्रस्टीयों , ट्रस्टीयो, 		
ट्रांजैक्शन्	आङ्ग्लभाषा	लेन-देन	transaction	ट्रांजेक्शन, ट्रांजैक्शन		
ट्राफिक्	आङ्ग्लभाषा	यातायात, वाणिज्य, लोकव्यवहार, लोकवात्रा, गमनागमन, 	traffic 		^ट्र(ा|ेै)फ(ि|ी)क(्)?$	
ट्रेड्	आङ्ग्लभाषा	व्यापार, 	trade	ट्रेड		
ट्रैनिंग्	आङ्ग्लभाषा	प्रशिक्षण	training	ट्रेनिंग, ट्रैनिंग		
टाइगर्	आङ्ग्लभाषा	व्याघ्र, शार्दूल, बाघ, 	tiger	टाइगर 		
टाइप्	आङ्ग्लभाषा	प्रकार, ढंग, मुद्रलेखन,	type	टाइप		
टाइम्	आङ्ग्लभाषा	समय, काल, 	time	टाइम		
टाइम्लाइन्	आङ्ग्लभाषा	कालरेखा	timeline	टाइमलाइन		
टार्गेट्	आङ्ग्लभाषा	लक्ष्य, ध्येय, 	target	टार्गेट, टारगेट, टारगेट्		
टास्कफोर्स्	आङ्ग्लभाषा	कार्यदल	task force 	टास्कफोर्स		
टिप्स्	आङ्ग्लभाषा	परामर्श, उपदेश	tips	टिप्स		
टीचर्	आङ्ग्लभाषा	शिक्षक 	teacher	टीचर 		
टीम्	आङ्ग्लभाषा	टोली, समूह, मण्डली, दल, 	team		^ट(ि|ी)म(्|्स्|्स|ें)?$	
टूरिझम्	आङ्ग्लभाषा	पर्यटन	tourism	टूरिज्म		
टेंट्	आङ्ग्लभाषा	पटमण्डप, पटगृह, पटकुटि, तम्बू, वस्त्रगृह, 	tent	टेंट 		
टेंशन्	आङ्ग्लभाषा	तनाव, चिन्ता,	tension	टेन्शन , टेंशन		
टोन्	आङ्ग्लभाषा	सुर, स्वर, 	tone	टोन		
टोप्	आङ्ग्लभाषा	शिर्ष, सर्वोच्च, ऊपर, प्रथम, 	top		^ट(ो|ॉ)प(्)?$	
टोर्चर्	आङ्ग्लभाषा	पीडन, यातना, कष्ट, उत्पीडन, 	torture 	टॉर्चर, टोर्चर		
टैक्स्	आङ्ग्लभाषा	कर 	tax	टैक्स 		
						
ड्यूटी	आङ्ग्लभाषा	कर्त्तव्य, कार्य	duty			
ड्राइवर्	आङ्ग्लभाषा	चालक	driver	ड्राइवरो, ड्राइवरों, ड्राइवर		
डाटा	आङ्ग्लभाषा	सूचना, ज्ञान	data	डेटा		
डांस्	आङ्ग्लभाषा	नृत्य	dance	डांस, डान्स		
डायबिटीज	आङ्ग्लभाषा	मधुप्रमेह, बहुमूत्रमेह, बहुमूत्ररोग, इक्षुमेह, प्रमेह,	diabetes	डायबीटीज, डायाबिटीज, डायाबीटीज		
डायमंड्	आङ्ग्लभाषा	हीरा 	diamond 	डायमंड, डायमंड्स 		
डायरेक्टर् 	आङ्ग्लभाषा	निर्देशक,  सञ्चालक,  प्रबन्धक 	director	डायरेक्टर, डायरेक्टर्स, 		
डिएक्टिवैट्	आङ्ग्लभाषा	निष्क्रिय 	deactivate	डिएक्टिवेट		
डिक्श्नरी	आङ्ग्लभाषा	कोष, शब्दकोष, शब्दसङ्ग्रह, 	dictionary 	डिक्शनरी	^ड(ि|ी)क्श(्)?नर(ि|ी)$	
डिजर्व्	आङ्ग्लभाषा	अधिकार/योग्य/उचित होना, 	deserve			
डिटेल्	आङ्ग्लभाषा	विवरण, विस्तार,	detail	डिटेल, डिटेल्स, 		
डिफेंस्	आङ्ग्लभाषा	रक्षा, प्रत्युत्तर	defence	डिफेन्स, डिफेंस		
डिमांड्	आङ्ग्लभाषा	मांग,  याचना, अभियोग,  	demand	डिमांड, डिमांड्स।		
डिमेंशिया	आङ्ग्लभाषा	मनोभ्रम				
डिसएग्री	आङ्ग्लभाषा	असहमत	disagree			
डील्	आङ्ग्लभाषा	क्रय-विक्रय, पण, व्यापार, 	deal	डील		
डेड्	आङ्ग्लभाषा	मृत, निष्प्राण	dead	डेड		
डेथ्	आङ्ग्लभाषा	मृत्यु, अवसान	death	डेथ		
डेप्युटी	आङ्ग्लभाषा	उप-	deputy			
डेफिनेटली	आङ्ग्लभाषा	निश्चित रूप से, अवश्य, 	definitely 		^डेफ(ि|ी)न(े|ेै)ट(्)?ल(ि|ी)$	
डेमेज्	आङ्ग्लभाषा	क्षति, हानि, नाश, भंग, दोष, क्षय, ध्वंस, 	damage		^ड(े|ेै)म(े|ि)ज(्)?$	
डेयरी	आङ्ग्लभाषा	दुग्धालय	dairy	डेयरी		
डोक्टर्	आङ्ग्लभाषा	वैद्य , ज्ञानी	doctor	डाक्टर, डॉक्टर, डोक्टर	^ड(ो|ॉ)क्टर(्|्स्|्स)?$	
						
तआला	अरबी	श्रेष्ठ, महान, सर्वशक्तिमान				
तकदीर	अरबी	भाग्य				
तकनीक	आङ्ग्लभाषा	यांत्रिकी , प्रविधि, पद्धति, शिल्प	technic			
तकनीकी	आङ्ग्लभाषा	प्राविधिक, शिल्पक, प्रौद्योगिकी				
तकरार	अरबी	विवाद				
तकरीज	अरबी	आलोचना				
तकलीफ	अरबी	समस्या, कष्ट, विपत्ति		तकलीफों, तकलीफें		
तकरीब	अरबी	सामीप्य				
तकरीबन	अरबी	लगभग	تقريبا			
तकरीम	अरबी	प्रतिष्ठा, सम्मान				
तकाबुल	अरबी	युद्ध, स्पर्धा, सम्मुख, समक्ष, 		तकाबूल		
तजुर्बा	अरबी	अनुभव , परीक्षण		तजुर्बे, तज़ुरबा		
तंदुरुस्त	फारसी	स्वस्थ, निरोगी		तन्दुरस्त, तन्दुरूस्त, तन्दुरुस्त, तंदुरूस्त, तंदुरुस्त, तंदरुस्त		
तंदुरुस्ती	फारसी	स्वास्थ्य, आरोग्य		तन्दुरस्ती, तन्दुरूस्ती, तन्दुरुस्ती, तंदुरूस्ती, तंदुरुस्ती		
तनख़ा	फारसी	वेतन		तनख़ाह, तनख्वाह, तनख्वाहें, तनख्वाहों, तनख्वा		
तनहाई	फारसी	एकान्त		तन्हाई, तन्हाईयां, तनहाईयां, तन्हाईया, तनहाईया, तन्हाइयां		
तनासुल	अरबी	???				
तपाक	फारसी	आवेश, उत्साह,				
तफ़ावत	अरबी	अन्तर				
तब्दील	अरबी	परिवर्तन		तबदील		
तब्दीली	अरबी	परिवर्तन		तबदीली, तब्दीलियां, तबदीलीयां		
तबका	अरबी	श्रेणी, वर्ग, विभाग, समूह,		तबके		
तबरेज	फारसी	???				
तबाह	फारसी	खण्डित, नष्ट				
तबादला	अरबी	स्थानांतरण, परिवर्तन		तबादले		
तबाही	फारसी	विनाश, प्रलय, विध्वंस				
तबियत	अरबी	स्वास्थ्य, आरोग्य	طبيعة	तबीयत		
तंबाकू	पुर्तगाली	???				
तमगा	तुर्की	पुरस्कार				
तमंचा	फारसी	???				
तमन्ना	अरबी	आकांक्षा, कामना		तमन्नाओं, तमन्नाओ, तमन्नाएं		
तमाचा	फारसी	थप्पड़				
तमाजत	अरबी	तीव्रता				
तमाम	अरबी	समस्त, समाप्त				
तमाशा	अरबी	???				
तमीज़	अरबी	विवेक, शिष्टाचार				
तमीजदार	अरबी+फारसी	शिष्ट, सभ्य, विवेकी, भद्र				
तय	अरबी	निश्चित, निर्णीत				
तर्ज़	अरबी	रीति, शैली, ढङ्ग				
तर्बियत्	अरबी	पालन-पोषण, प्रशिक्षण, 		तर्बियत, तर्बिय्यत, तरबियत, 		
तरक्की	अरबी	प्रगति, उन्नती, विकास				
तरकारी	फारसी	शाक,				
तरकीब	अरबी	उपाय, युक्ति, ढङ्ग				
तरजीह	अरबी	प्रमुखता, प्रधानता, श्रेष्ठता,	تَرْجِیح			त
तरफ़	अरबी	पक्ष, दिशा				
तरफदार	अरबी+फारसी	समर्थक, पक्षपाती				
तरफदारी	अरबी+फारसी	पक्षपात				
तरफा	अरबी	पक्षीय				
तरह	अरबी	भाँति, प्रकार, ढङ्ग, समान, 				
तराजू	फारसी	तुला				
तराना	फारसी	गीत		तराने		
तराशना	फारसी	काटना, तक्षण		तराशा, तराशी		
तरीका	अरबी	उपाय, युक्ति, मार्ग, पद्धति, प्रकार, ढङ्ग		तरीकें, तरीके, तरीकों, तरीको		
तलफ्फुज	अरबी	उच्चारण				
तलब	अरबी	लालसा, कामना, तीव्रेच्छा, आह्वान				
तलाक	अरबी	विवाहविच्छेद, विवाहसम्बन्धभेद				
तलाश	तुर्की	शोध, अन्वेषण, परीक्षण, अनुसन्धान		तलाशी, तलाशती, तलाशने, तलाशा, तलाशता, तलाशते		
तलाशी	तुर्की	शोध				
तवज्जो	अरबी	महत्व, मान				
तवायफ़	अरबी	वेश्या		तवायफ़ो, तवायफ़ों		
तवील	अरबी	दीर्घ				
तशरीफ	अरबी	सम्मान, आदर,				
तस्दीक	अरबी	पुष्टि				
तस्वीर	अरबी	चित्र, छवि		तस्वीरों, तस्वीरो, तस्वीरें, तस्वीरे, तसवीर		
तसबीह	अरबी	जपमाला				
तसल्ली	अरबी	सन्तोषप्रदता, सन्तुष्टि, सन्तोष				
तसव्वुर	अरबी	कल्पना, विचार				
तहकीकात	अरबी	खोज, शोध, जाँच, अनुसंधान, अन्वेषण, परीक्षण 				
तहजीब	अरबी	सभ्यता, शिष्टता		तहजीबों,		
तहत	अरबी	अन्तर्गत				
तहरीर	अरबी	लिखावट, लेखनशैली, पत्र				
तहलका	अरबी	कोलाहल, उत्पात, हलचल				
ताउम्र	अरबी	जीवनभर, जीवनपर्यंत				
ताकत	अरबी	बल, शक्ति		ताकतों, ताकात, ताकतें		
ताक़तवर	अरबी	शक्तिशाली, बलवान्				
ताकि	फारसी	इसलिए, अतएव		ताकी		
ताज्जुब	अरबी	आश्चर्य		ताजुब		
ताजवर	फारसी	राजा				
ताजा	फारसी	अशुष्क, नूतन				
ताबीर	अरबी	स्वप्न फल, स्वप्न वर्णन		ताबीरें, ताबीरों		
तारीकी	फारसी	अन्धकार, कज्जल				
तारीख़	अरबी	तिथि, दिनाङ्क, इतिहास		तारीखें		
तारीफ	अरबी	प्रशंसा		तारीफों, तारीफे		
ताल्लुक़	अरबी	संबंध, लगाव, प्रेम, पक्षपात		तअल्लुक, ताल्लुक़ात		
तालाब	फारसी	जलाशय		तालाबों		
तालीम	अरबी	शिक्षा, अभ्यास, ज्ञान				
तावीज	अरबी	जंतर, तांत्रिक यंत्र		ताबीज		
तासीर	अरबी	प्रभाव		तासिर		
तिजोरी	आङ्ग्लभाषा	???				
तिश्नगी	फारसी	उत्कंठा, अभिलाषा, तृष्णा, तीव्रेच्छा				
तुग़यानी	अरबी	बाढ़, प्रलय, पूर		तुग़्यानी		
तुपक	तुर्की	???				
तूफां	अरबी	आँधी				
तूफान	अरबी	आँधी				
तेज़ी	फारसी	उग्रता, प्रचण्डता, तीव्रता, प्रबलता, शीघ्रता				
तोप	तुर्की	???				
तोपगाड़ी	तुर्की+हिन्दी	???				
तोपची	तुर्की	???				
तोहफा	अरबी	उपहार	تُحْفَة	तोहफे, तोफा, तौफा		1. तोप से गोला दागने वाला व्यक्ति; गोलंदाज़ 2. तोप सैनिक 3. तोप संचालक।
तोहमत	अरबी	मिथ्या आरोप		तोहमते, तोहमतें		
तैनात	अरबी	नियुक्त				
तैनाती	अरबी	नियुक्ति				
तैयार	अरबी	तत्पर, उद्यत, प्रस्तुत, कटिबद्ध, उपस्थित, सज्ज				
तैयारी	अरबी+फारसी	आयोजन, प्रबन्ध, उद्यत, सज्जीकृत		तैयारियां, तैयारियों, तेयारी, तैयारियाँ		
तैश	अरबी	क्रोध				
तौबा	अरबी	पश्चाताप				
तौर	अरबी	रूप				
तौलिया	आङ्ग्लभाषा+हिन्दी	अँगोछा				
						
थेंक्यू	आङ्ग्लभाषा	धन्यवाद, आभार, 	thank you		^थ(े|ेै)(न्|ं|ङ्)क्य(ु|ू)$	
थेंक्स्	आङ्ग्लभाषा	धन्यवाद, आभार, 	thanks		^थ(े|ेै)(न्|ं|ङ्)क्स(्)?$	
						
दखल	अरबी	हस्तक्षेप, प्रवेश, अधिकार				
दखलंदाजी	अरबी+फारसी	हस्तक्षेप		दखलअंदाजी		
दफ्तर	अरबी	कार्यालय				
दफन	अरबी	???		दफ्न		
दफा	अरबी	वार, धारा, तिरस्कृत				
दंगल	फारसी	मल्लयुद्ध		दन्गल		
दंगा	फारसी	उपद्रव		दंगे		
दम	फारसी	प्राण, श्वास, शक्ति, बल				
दर्ज	अरबी	अङ्कित, प्रविष्ट, पञ्जीकृत				
दर्जन	आङ्ग्लभाषा	बारह , द्वादश	dozen	दर्जनों, दर्जनो		
दर्जा	अरबी	कक्षा, वर्ग, श्रेणी, स्थान		दरजा, दर्जे, दरजे		
दर्द	फारसी	कष्ट, दुःख, पीड़ा, व्यथा				
दर्दनाक	फारसी	कष्टप्रद, करुणाजनक,कष्टदायक,				
दरअसल	अरबी	वास्तव में, वस्तुतः, यथार्थ में				
दरकार	फारसी	आवश्यक, आवश्यकता				
दरकिनार	फारसी	अलग, अनदेखा				
दरख्त	फारसी	वृक्ष				
दरबार	फारसी	राजसभा, सभा				
दरबारी	फारसी	सभासद		दरबारियों		
दरवाज़ा	फारसी	द्वार, प्रवेशमार्ग		दरवाजे		
दरिन्दा	फारसी	क्रूर, निर्दयी, मांसभक्षी पशु		दरिंदा, दरिंदों, दरिन्दे, दरिंदे , दरिंदो, दरिन्दों, दरिन्दो		
दरिया	फारसी	नदी, समुद्र				
दरियादिल	फारसी	उदार				
दरियादिली	फारसी	उदारता, सहृदयता, सज्जनता				
दरीचा	फारसी	उपद्वार		दरीची		
दलाल	अरबी	बिचौलिया		दलालों		
दलाली	अरबी	मध्यस्थता				
दवा	अरबी	औषधि, उपचार, चिकित्सा		दवाओं,		
दवाई	अरबी	औषधि, उपचार, चिकित्सा		दवाइयां, दवाइयाँ, दवाइयों		
दस्तक	फारसी	???				
दस्तखत	अरबी+फारसी	हस्ताक्षर				
दस्तूर	फारसी	रीति, प्रथा, परंपरा				
दहलीज	फारसी	द्वार		देहलीज		
दहशत	अरबी	आतङ्क, भय, त्रास				
दहशतगर्द	अरबी+फारसी	आतंकवादी, त्रासवादी		दहशतगर्दो, दहशतगर्दों		
दाद	फारसी	प्रशंसा, न्याय				
दादख्वाह	फारसी	न्यायेच्छु				
दामन	फारसी	पल्ला				
दामाद	फारसी	जमाई				
दायर	अरबी	???				
दायरा	अरबी	कार्यक्षेत्र, वृत्त		दायरे		
दारू	फारसी	मद्य, मदिरा, औषध, उपचार				
दावत	अरबी	निमन्त्रण, आमन्त्रण,				
दावा	अरबी	अधिकार, आत्मविश्वास, अभियोग		दावे		
दावेदार	अरबी+फारसी	अधिकारी				
दास्तान	फारसी	कथा, कहानी, वर्णन		दास्तां, दास्तानों, दास्तानो,		
दिक्कत	अरबी	कष्ट, समस्या		दिक्कतें, दिक्कते, दिक्कतों		
दिमाग़	अरबी	बुद्धि, समझ, मस्तिष्क		दीमाग		
दिल्लगी	फारसी	मनोविनोद, परिहास, प्रेम, स्नेह				
दिल	फारसी	हृदय, मन		दिलों		
दिलकश	फारसी	मनमोहक, चित्ताकर्षक				
दिलचस्प	फारसी	मनोरञ्जक, चित्ताकर्षक, हृदयग्राही, अनुरागजनक, विनोदक				
दिलचस्पी	फारसी	रुचि, मनोरञ्जकता, अनुराग, रस				
दिलबर	फारसी	प्रिय, प्रेमी		दिलबरो, दिलबरों		
दिलवाला	फारसी	उदार, साहसी, दाता		दिलवाले		
दिलावर	फारसी	वीर, साहसी, पौरुषवान		दिलेर		
दिलावरी	फारसी	वीरता, साहस, पौरुष		दिलेरी		
दिली	फारसी	हार्दिक				
दिवाना	फारसी	उन्मत्त, वातुल, भ्रष्टबुद्धि		दीवाना, दिवाने, दीवाने		
दीदार	फारसी	दर्शन, साक्षात्कार, सौंदर्य	ديدار‎	दिदार		
दीवार	फारसी	भीत		दीवारें , दिवारों, दीवारों		
दुआ	अरबी	प्रार्थना, आशीर्वाद, विनती		दुआओं, दुआओ, दुवा, दुवाओं, दुआँ, दुआं, दुआएं, दुआएँ ,		
दुकान	फारसी	आपण		दुकानें, दुकानों		
दुकानदार	फारसी	व्यापारी				
दुकानदारी	फारसी	व्यापार				
दुनिया	अरबी	संसार, विश्व, जगत्		दुनियां, दुनियाँ, दुनियाको, दुनियाओं		
दुनियादार	अरबी+फारसी	व्यवहारकुशल, गृहस्थ, संसारी		दुनियाँदार		
दुनियादारी	अरबी+फारसी	व्यवहार-कुशलता, लोकव्यवहार,		दुनियाँदारी		
दुनियाभर	अरबी	समग्र विश्व				
दुरुस्त	फारसी	उचित, उपयुक्त, ठीक, यथार्थ, दोष रहित		दुरस्त		
दुश्मन	फारसी	शत्रु, वैरी		दुश्मनों, दुश्मनो		
दुश्मनी	फारसी	शत्रुता				
दोज़ख़	फारसी	नरक				
दोयम	फारसी	द्वितीय				
दोस्त	फारसी	मित्र, साथी, सखा, बन्धु, सुहृत्, वयस्य, स्निग्ध		दोस्तों, दोस्तो		
दोस्ती	फारसी	मित्रता, मैत्री, बन्धुत्व				द
दौर	अरबी	चक्कर, फेरा, क्रम, व्यवस्था, समय,				
दौरा	अरबी	यात्रा, चक्कर, भ्रमण		दौरे		
दौरान	अरबी	समय, काल				
दौलत	अरबी	धन, संपत्ति		दौलतें		
दौलतमंद	अरबी+फारसी	धनवान, धनाढ्य, समृद्ध, संपन्न		दौलतमन्द, दौलतमंदो, दौलतमंदों,		
						
धंधेबाज	हिन्दी+फारसी	???		धंधेबाजों		
धोखेबाज	उर्दू	कपटी, धूर्त		धोखेबाजों		
धोखेबाजी	उर्दू	कपट, छल				
						
न्यू	आङ्ग्लभाषा	नव, नवीन, नूतन, आधुनिक, अभूतपूर्व, 	new			
न्यूज्	आङ्ग्लभाषा	समाचार, वार्ता	news	न्यूज		
न्यूट्रल्	आङ्ग्लभाषा	तटस्थ, निष्पक्ष	neutral	न्युट्रल, न्यूट्रल		
न्यूट्रालिटी	आङ्ग्लभाषा	तटस्थता, निष्पक्षता	neutrality	न्युट्रालिटी,		
न्यूट्रिशन्	आङ्ग्लभाषा	पोषण, पोषक तत्व	nutrition	न्यूट्रिशन्स, न्यूट्रिशन		
नक्शा	अरबी	मानचित्र		नक्शे		
नक्शेकदम	अरबी	पदचिह्न, अनुकरण				
नकद	अरबी	रोकड़				
नक़ल	अरबी	अनुकृति, अनुकरण				
नकली	अरबी	मिथ्या, काल्पनिक, कृत्रिम				
नखरा	फारसी			नखरे, नखरें		
नग़मा	अरबी	गीत		नग्मे, नग्मा		
नगीना	फारसी	मणि, रत्न				
नज़्म	अरबी	कविता, पद्य				
नजदीक	फारसी	समीप, निकट		नज्दीक, नजदिक		
नजदीकी	फारसी	निकट का, सम्बन्धी, समीपता, निकटता				
नजदीकियां	फारसी	सामीप्य, निकटता, समीपता		नजदीकियों		
नजर	अरबी	दृष्टि		नजरो, नजरों, नजरे, नजरें		
नजरअंदाज	अरबी+फारसी	उपेक्षा		नजरअन्दाज		
नजरिया	अरबी	दृष्टिकोण		नजरिये , नजरिए		
नजला	अरबी	प्रतिश्याय, पीनस,				
नज़ाकत	फारसी	कोमलता,				
नज़ारा	अरबी	दृश्य		नजारे		
नज़ीर	अरबी	उदाहरण, दृष्टान्त				
नतीजा	अरबी	परिणाम, फल		नतीजों, नतीजो, नतीजे, नतीजें		
नफरत	अरबी	घृणा, द्वेष		नफ़रतों		
नफ़ा	अरबी	लाभ, हित, अर्जन	نفع			न 
नफ़ासत	अरबी	कोमलता, स्वच्छता, सुन्दरता, निर्मलता				
नफ़ीस	अरबी	कोमल, स्वच्छ, सुन्दर, निर्मल				
नम्बर	आङ्ग्लभाषा	क्रम, सङ्ख्या, क्रमाङ्क	number	नंबर		
नंबरदार	आङ्ग्लभाषा+फारसी	???		नम्बरदार		
नमक	फारसी	लवण				
नमूना	फारसी	प्रतिमान				
नर्म	फारसी	कोमल , मृदु , शिथिल		नरम		
नर्वस	आङ्ग्लभाषा	मज्जातन्तुसम्बन्धी, उद्विग्न, व्यग्र,	nervous			
नवाज	फारसी	कृपालु, दयालु				
नवाजना	फारसी	पुरस्कृत करना, सम्मानित करना		नवाजें		
नवाजा	फारसी	पुरस्कृत किया, सम्मानित किया				
नवाब	अरबी	प्रशासक		नवाबों		
नशा	फारसी	मद, प्रमाद, मादकता, उन्माद		नशे		
नस्ल	अरबी	वंश, सन्तति	نسل	नसल		
नस्लभेद	अरबी+हिन्दी	वंशभेद				
नस्लभेदी	अरबी+हिन्दी	वंशभेदी				
नस्लवाद	अरबी+हिन्दी	वंशवाद				
नस्लवादी	अरबी+हिन्दी	वंशवादी				
नस्लीय	अरबी	वंशीय				
नसीब	अरबी	भाग्य, प्राप्त		नसीबों		
नसीबदार	अरबी+फारसी	बहुश्रेयसी, भाग्यवान				
नसीहत	अरबी	सदुपदेश, उपदेश, शिक्षा				
नाइट्	आङ्ग्लभाषा	रात्रि, निशा,  	night	नाइट		
नाइंसाफी	अरबी	अन्याय		नाइन्साफी		
नाउम्मीद	फारसी	निराश, हताश		नौमीद, नाउमीद		
नाउम्मीदी	फारसी	निराशा, हताशा		नौमीदी, नाउमीदी		
नाकाम	फारसी	असफल				
नाकामयाब	फारसी	असफल, विफल				
नाकामी	फारसी	असफलता				
नाखुदा	फारसी	नाविक, कर्णधार, केवट				
नाखुश	फारसी	अप्रसन्न, असन्तुष्ट				
नाज़	फारसी	गर्व				
नाजायज	अरबी+फारसी	अनुचित, अवैध, अनुपयुक्त		नजायज		
नाजुक	फारसी	गम्भीर, कोमल, मृदु				
नादान	फारसी	अज्ञानी, मुर्ख				
नादानी	फारसी	अज्ञानता, मूर्खता, अकुशलता				
नापाक़	फारसी	अपवित्र, अशुद्ध				
नाबाद	अरबी	???				
नाबालिग	अरबी+फारसी	अवयस्क				
नाबूद	फारसी	लुप्त, विध्वस्त		नाबुद		
नामर्द	फारसी	नपुंसक, कायर, डरपोक		नामर्दों, नामर्दो		
नामाकूल	अरबी+फारसी	अयोग्य, अनुचित, अपूर्ण		नामाकुल		
नामुमकिन	अरबी	असम्भव				
नाराज़	अरबी+फारसी	रुष्ट, अप्रसन्न, असन्तुष्ट				
नाराजगी	अरबी+फारसी	अप्रसन्नता, असन्तुष्टि				
नायाब	फारसी	अप्राप्य, दुष्प्राप्य				
निकम्मा	???	???				
निगरानी	फारसी	निरीक्षण				
निगाह	फारसी	दृष्टि, ध्यान		निगाहें, निगाहे, निगाहों, निगाहो		
निजात	अरबी	मोक्ष, मुक्ति				
निशाना	फारसी	लक्ष्य		निशाने		
निशानी	फारसी	चिह्न, स्मृतिचिह्न				
निहायत	अरबी	अत्यंत, अत्याधिक				
नीयत	अरबी	विचार, इच्छा, आशय, उद्देश्य	نِيَّةٌ			
नुकसान	अरबी	क्षति, हानि, क्षय				
नुकसानदायक	अरबी+हिन्दी	हानिकारक, अहितकारी				
नुमाइश	फारसी	प्रदर्शन, दिखावट		नुमाईश		
नुमायाँ	फारसी	व्यक्त, स्पष्ट, प्रकट		नुमाँया		
नुस्ख़ा	अरबी	औषधि, विधि, उपाय		नुस्खे, नुस्खें, नुस्खो, नुस्खों		
नूर	अरबी	प्रकाश, ज्योति				
नेक	फारसी	भला, उत्तम, श्रेष्ठ, शुभ, शिष्ट, परोपकारी				
नेकी	फारसी	भलाई, परोपकार, शिष्टाचार				
नेगेटिव	आङ्ग्लभाषा	नकारात्मक,	negative	निगेटिव		
नेचुरल	आङ्ग्लभाषा	प्राकृतिक	natural	नेचरल		
नेमत	अरबी	धन, सम्पत्ति, सुख, समृद्धि, आनन्द		ने'मत, नेअमत		
नेशन	आङ्ग्लभाषा	राष्ट्र	nation			
नेशनल	आङ्ग्लभाषा	राष्ट्रीय	national			
नेस्तनाबूद	फारसी	समूल नष्ट		नेस्तनाबूद		
नोटिस्	आङ्ग्लभाषा	दृष्टि, सूचना, निर्देश, सूचनपत्र, अवलोकन, घोषणापत्र, 	notice	नोटिस		
नोर्थ्	आङ्ग्लभाषा	उत्तर	north	नॉर्थ		
नौकर	तुर्की	सेवक, कर्मचारी, भृत्य		नोकर		
नौकरशाह	तुर्की+फारसी	सेवकराज		नोकरशाह		
नौकरशाही	तुर्की+फारसी	???		नोकरशाही		
नौकरानी	तुर्की+हिन्दी	सेविका, भृत्या,				
नौकरी	तुर्की+हिन्दी	सेवा		नौकरियां , नोकरी		
नौजवान	फारसी	नवयुवक, नवयुवान		नौजुवान, नौजवानो, नौजवानों		
नौबत	अरबी	दुर्गति, दुर्दशा		नोबत		
						
प्राइवेट् 	आङ्ग्लभाषा	निजी,  व्यक्तिगत	private 	प्राइवेट		
प्रूफ्	आङ्ग्लभाषा	प्रमाण, सिद्धि, अभेद्य, 	proof	प्रूफ 		
प्रेक्टिकल्	आङ्ग्लभाषा	व्यावहारिक	practical	प्रैक्टिकल, प्रेक्टिकल		
प्रेग्नेंट	आङ्ग्लभाषा	गर्भवती	pregnant	प्रेगनेंट, प्रेग्नंट		
प्रेशर्	आङ्ग्लभाषा	दबाव	pressure	प्रेशर		
प्रोजेक्ट्	आङ्ग्लभाषा	योजना, परियोजना	project 	प्रोजेक्ट		
प्रोटेस्ट्	आङ्ग्लभाषा	आन्दोलन	protest	प्रोटेस्ट		
प्रोटोकॉल्	आङ्ग्लभाषा	शिष्टाचार, औपचारिकता,	protocol	प्रोटोकॉल		
प्रोपर्टी	आङ्ग्लभाषा	सम्पत्ति, धन, गुण, लक्षण	property	प्रॉपर्टी		
प्रोपागेण्डा	आङ्ग्लभाषा	दुष्प्रचार	propaganda	प्रॉपगैंडा, प्रोपागेण्डा, प्रॉपगेंडा,		
प्रोफेश्नल्	आङ्ग्लभाषा	व्यावसायिक	professional	प्रोफेशनल		
प्रोब्लेम्	आङ्ग्लभाषा	समस्या	problem	प्रोब्लम , प्रॉब्लम, प्रोब्लेम		
प्रैक्टिस्	आङ्ग्लभाषा	अभ्यास, कार्य, 	practice 	प्रैक्टिस		
प्लान्	आङ्ग्लभाषा	योजना, परियोजना	plan	प्लान		
प्लानिंग्	आङ्ग्लभाषा	योजना, आयोजन	planning	प्लानिंग		
प्लेस्	आङ्ग्लभाषा	स्थान, स्थल, 	place	प्लेस, प्लेसेज, 		
पगार	तुर्की	वेतन				
पत्थरदिल	हिन्दी+फारसी	पाषाणहृदयी				
पनाह	फारसी	शरण		पनाहों		
पब्लिक्	आङ्ग्लभाषा	जनता, लोक, सार्वजनिक,  	public	पब्लिक 		
पर्दा	फारसी	पट, आवरण, यवनिका		परदा, पर्दे, परदे		
पर्शियन	आङ्ग्लभाषा	फ़ारसी	persian			
पर्शिया	आङ्ग्लभाषा	फ़ारस	persia			
परवरिश	फारसी	पालन-पोषण, देखरेख				
परवा	फारसी	चिंता		परवाह		
परहेज	फारसी	परिवर्जन, निवर्तन,				
परिंदा	फारसी	पक्षी, खग		परिंदों, परिन्दों		
परी	फारसी	अप्सरा				
परेशान	फारसी	व्याकुल, उद्विग्न, चिन्तित, विक्षुब्ध		परेशाँ		
परेशानी	फारसी	व्याकुलता, उद्विग्नता, कष्ट, समस्या		परेशानियों, परेशानियो, परेशानियां, परेशानियाँ		
पशेमाँ	फारसी	लज्जित,		पशेमान		
पसंद	फारसी	रुचि, रुचिकर, चयन, स्वीकृति, प्रिय, मनभावन		पसन्द		
पसंदीदा	फारसी	मनभावन, प्रिय, रूचिकर		पसन्दीदा		
पहलवान 	फारसी	मल्ल 				
पाजेब	फारसी	नूपुर, पायल, 				
पाबंदी	फारसी	प्रतिबन्ध, अधीनता, बाध्यता, 		पाबंदियाँ	^पाब(न्|ं)द(ि|ी)(या|यां|याँ|यो|यों|योँ)?$	
पार्ट्	आङ्ग्लभाषा	भाग	part	पार्ट		
पार्टी 	आङ्ग्लभाषा	पक्ष	party		^पार्ट(ि|ी)(ज्|ज|यां|याँ|यों|योँ)?$	
पार्टनर्	आङ्ग्लभाषा	सहभागी, साथी, सङ्गी	partner	पार्टनर		
पाशा	तुर्की	???				
पास्पोर्ट्	आङ्ग्लभाषा	अभयपत्र, अभिज्ञानपत्र, अभिज्ञामुद्रा, 	passport	पासपोर्ट		
पिस्तौल	आङ्ग्लभाषा	???	pistol			तुर्किस्तान में बड़े अधिकारियों और सरदारों को दी जाने वाली उपाधि।
पीएम्	आङ्ग्लभाषा	प्र०मं०, प्रधानमन्त्री, 	pm	पीएम 		
पीडियाट्रिक्	आङ्ग्लभाषा	बालचिकित्सा	pediatric	पीडियाट्रिक		
पुरखुलूस्	अरबी	सत्य, निष्कपट, यथार्थ, 		पुरखुलूस्		
पुरसुकून	अरबी	शान्तिपूर्ण,				
पुलिस्	आङ्ग्लभाषा	???	police	पुलिस		
पुलिस्कर्मी	आङ्ग्लभाषा+हिन्दी	सुरक्षाकर्मी		पुलिसकर्मी		
पेरेंट्	आङ्ग्लभाषा	जनक, मूल, मातापिता, 	parent	पेरेंट्स, पेरेंट्स्, 		
पेश	फारसी	उपस्थित, प्रस्तुत				
पेशकश	फारसी	प्रस्तुति, उपहार, निवेदन				
पेशगी	फारसी	अगाऊ, अग्रिम धन				
पेशी	फारसी	प्रस्तुति, उपस्थिति				
पेशा	फारसी	व्यवसाय				
पैग़ाम	फारसी	सन्देश, समाचार				
पैटर्न्	आङ्ग्लभाषा	प्रतिमान, ???	pattern	पैटर्न्स, पैटर्न 		
पैमाना	फारसी	मानदण्ड, स्तर, परिमाण		पैमाने		
पोजिटिविटी	आङ्ग्लभाषा	सकारात्मकता	positivity	पॉजिटिविटी		
पोप्युलेशन्	आङ्ग्लभाषा	जनसङ्ख्या	population	पॉप्युलेशन		
पोल्यूशन्	आङ्ग्लभाषा	प्रदूषण	pollution	पॉल्युशन, पॉल्यूशन		
पोलिसी	आङ्ग्लभाषा	नीति	policy	पॉलिसी		
पोलिटिकल्	आङ्ग्लभाषा	राजनैतिक, राजकीय, 	political 		^प(ो|ॉ)ल(ि|ी)ट(ि|ी)कल(्)?$	
पोशाक	फारसी	वेश, परिधान, वस्त्र				
पोस्टर्	आङ्ग्लभाषा	विज्ञापन, ???	poster	पोस्टर		
पोसिबल्	आङ्ग्लभाषा	सम्भव	possible	पॉसीबल, पोसिबल, पोसीबल, पॉसिबल	^प(ो|ॉ)स(ि|ी)बल(्)?$	
						
फ्यूचर्	आङ्ग्लभाषा	भविष्य	future	फ्युचर, फ्यूचर		
फ्री 	आङ्ग्लभाषा	निःशुल्क, मुक्त, स्वतन्त्र 	free			
फक्त	अरबी	केवल, मात्र	فقط	फकत		
फकीर	अरबी	भिक्षुक, दरिद्र				
फ़क़ीरी	अरबी	सादगी, निर्धनता,				
फख्र	अरबी	गर्व, अभिमान		फक्र		
फ़ज़्ल	अरबी	???				
फजीहत	अरबी	अपयश, कलङ्क, निन्दा, अपमान, दुर्दशा, दुर्गति,		फजिहत		
फण्ड्	आङ्ग्लभाषा	धन, निधि, पूंजी,  	fund		^फ(ण्|ं)ड(्)?$	
फतवा	अरबी	[मूलअर्थ: इस्लामिक आदेश, निर्णय अथवा घोषणा]	فتوى‎	फतवे, 		
फ़तह	अरबी	विजय, सफलता		फ़तेह		
फंगस्	आङ्ग्लभाषा	ऊर्व्यङ्ग, कुकुरमुत्ता, छत्रक	fungus	फंगस		
फर्क	अरबी	अंतर		फरक		
फर्ज	अरबी	कर्तव्य		फ़रज़ी		
फर्जी	अरबी	काल्पनिक, मिथ्या, भ्रामक				
फ़रज़ंद	फारसी	पुत्र				
फरमाइश	फारसी	आग्रह, निवेदन, अनुरोध		फर्माइश		
फ़रमान	फारसी	आदेश, आज्ञा, आज्ञापत्र, निर्देश				
फरमाना	फारसी	आज्ञा देना, कहना		फरमाएं		
फरमाया	फारसी	कहा				
फ़रामोश	फारसी	विस्मृत				
फ़रार	फारसी	पलायित, चंपत				
फरियाद	फारसी	अभियोग				
फरियादकर्ता	फारसी+हिन्दी	अभियोक्ता				
फरियादी	फारसी	अभियोक्ता				
फरेब	फारसी	छल, कपट, धूर्तता, 		फरेबों		
फरोख्त	फारसी	विक्रय, विक्री, 				
फलक	अरबी	आकाश, गगन, 				
फ़लीता	तुर्की	???				
फसल	अरबी	उपज, पैदावार, उत्पाद		फसलों		
फ़साद	अरबी	उपद्रव, उत्पाद, विकार, क्लेश				
फाइनल्	आङ्ग्लभाषा	अन्तिम	final	फाईनल, फाइनल		
फाउण्डेशन्	आङ्ग्लभाषा	संस्थान, आधार, स्थापना, प्रतिष्ठान, 	foundation 		^फा(उ|ऊ)(न्|ं|ण्)डेशन(्)?(स्|स)?$	
फ़ाज़िल	अरबी	विद्वान				
फ़ायदा	अरबी	लाभ, हित, अर्जन	فائدة	फायदे		
फायदेमंद	अरबी+फारसी	लाभदायक, लाभकारी				
फासला	फारसी	अन्तर	فاصلہ	फासले		
फिक्र	???	चिन्ता		फिकर		
फिजा	फारसी	शोभा			^फ(ि|ी)जा(ओ|ओं)?$	
फिजिकल्	आङ्ग्लभाषा	शारीरिक, भौतिक	physical	फिजिकल	^फ(ि|ी)ज(ि|ी)कल(्)?$	
फिजूल	अरबी	व्यर्थ,				
फितरत	अरबी	स्वभाव, प्रकृति		फ़ित्रत		
फितूर	अरबी	दोष, विघ्न, उपद्रव		फितुर, फीतूर, फीतुर, फ़ुतूर,		
फितूरी	अरबी	???				
फ़िदवी	अरबी	सेवक, दास, आज्ञाकारी, स्वामिभक्त,				
फिदा	अरबी	बलिहारी				
फ़िरक़ा	अरबी	पंथ, संप्रदाय, समुदाय,				
फ़िरदौस	अरबी	वाटिका, उद्यान				
फ़िराक़	अरबी	वियोग, चिंता				
फिल्म् 	आङ्ग्लभाषा	चलचित्र, 	film	फिल्म, फिल्में, फिल्मों, फिल्म्स 		
फिलहाल	अरबी	अभी				
फीसदी	फारसी	प्रतिशत				
फ़ुरक़त	अरबी	वियोग		फ़ुर्क़त		
फुरसत	अरबी	अवकाश		फुर्सत		
फेमस्	आङ्ग्लभाषा	प्रसिद्ध, प्रख्यात, 	famous 	फेमस		
फेमिली	आङ्ग्लभाषा	परिवार	family	फॅमिली, फैमिली, 		
फेवरेट	आङ्ग्लभाषा		favorite 		^फ(े|ेै)वर(े|ि)ट(्)?$	
फेहरिस्त	अरबी	सूची, सूचीपत्र,				
फेक्ट्	आङ्ग्लभाषा	तथ्य, सत्य, यथार्थ, वास्तव, वस्तु, 	fact	फैक्ट, फैक्ट्स		
फैक्ट्री	आङ्ग्लभाषा	यन्त्रशाला, शिल्पगृह, शिल्पशाला, यन्त्रगृह, आवेशन, प्रावेशन, 	factory		^फ(े|ेै)क्ट(्)?र(ि|ी)(या|यां|याँ|यो|यों|योँ)?$	
फैन्	आङ्ग्लभाषा	प्रशंसक, व्यजन, पङ्खा	fan	फैन्स, फैन		
फैयाज़	अरबी	दानी, मुक्तहस्त, उदार,				
फैशन्	आङ्ग्लभाषा	लोकाचार, ???	fashion	फैशन 		
फैसल	अरबी	निर्णीत, न्यायकर्ता,				
फैसला	अरबी	निर्णय		फैसलों, फैसले, फैसलें		
फोटो	आङ्ग्लभाषा	चित्र, छवि	photo			
फोर्ट्	आङ्ग्लभाषा	गढ, दुर्ग	fort	फोर्ट		
फ़ोर्स	आङ्ग्लभाषा	बल, शक्ति, सेना	force			
फॉर्मूला	आङ्ग्लभाषा	सूत्र, विधि	formula	फोर्मूला, फॉर्म्यूला, फोर्म्यूला		
फ़ौज	अरबी	सेना, सैन्य		फौजें		
फौजी	अरबी	सैनिक, योद्धा		फौजियों		
फ़ौरन	अरबी	शीघ्र, तत्काल, तत्क्षण, त्वरित				
फ़ौरी	अरबी	महत्वपूर्ण, अत्यावश्यक,				
फौलाद	अरबी	लोहा, शक्तिशाली,				
फौलादी	अरबी	लोह, सशक्त,				
						
ब्यूरो	आङ्ग्लभाषा	कार्यालय, विभाग, केन्द्र, आधार, ग्रन्थकुटी, 	bureau	ब्यूरोज		
ब्रिज	आङ्ग्लभाषा	सेतु 	bridge			
ब्रैन्	आङ्ग्लभाषा	मस्तिष्क	brain	ब्रेन, ब्रैन, 		
ब्रोन्ज 	आङ्ग्लभाषा	कांस्य	bronge	ब्रॉन्ज 		
ब्लड्	आङ्ग्लभाषा	रक्त, लहू	blood	ब्लड		
ब्लू	आङ्ग्लभाषा	नीला	blue	ब्लु		
ब्लैक्	आङ्ग्लभाषा	कृष्ण	black	ब्लैक, ब्लैक्स		
ब्लैक्मेल	आङ्ग्लभाषा	भयादोहन	blackmail 	ब्लैकमेल, ब्लैकमेलिंग, 		
बक्सा	आङ्ग्लभाषा	पेटिका, सम्पुट, डिब्बा, 	box			
बक़ाया	अरबी	शेष				
बख्त	फारसी	भाग्य, सौभाग्य, प्रारब्ध				
बख़्शना	फारसी	क्षमा करना, छोड़ देना		बक्शा, बख्शा , बख्शेंगे, बख्शेंगा, बख्शेंगी, बख्श, बख्शते, बख्शता, बख्शती,		
बख़्शीश	फारसी	उपहार, दान, पारितोषिक, पुरस्कार		बखशीश, बखशिश		
बखूबी	फारसी	भलीभाँति		बखुबी		
बग़ावत	अरबी	विद्रोह				
बग़ैर	अरबी+फारसी	विना, ऋते, अन्तरेण				
बच्चा	फारसी	बालक, शिशु, पुत्र, सन्तान				
बज्म	फारसी	सभा, सम्मेलन				
बजाय	फारसी	के स्थान में		बजाए		
बतौर	अरबी+फारसी	सदृश, समान, के रूप से		बतौरन		
बदइंतजामी	फारसी	कुप्रबन्ध, अराजकता, अव्यवस्था				
बदकिस्मत	फारसी+अरबी	अभागा, भाग्यहीन				
बदकिस्मती	फारसी+अरबी	दुर्भाग्य				
बदजबान	फारसी	कटूभाषी, मुँहफट		बदजुबान		
बदतमीज	अरबी	असभ्य, धृष्ट, उद्धत, अभद्र		बतमीज, बद्तमीज		
बदतमीजी	अरबी	धृष्टता, अशिष्टता, अभद्रता				
बदतर	फारसी	दुष्टतर, कष्टतर, खलतर				
बदन	फारसी	शरीर, काया	بدن			
बदनसीब	फारसी+अरबी	अभागा, भाग्यहीन, दुर्भाग्य				
बदनसीबी	फारसी+अरबी	दुर्भाग्य				
बदनाम	फारसी+हिन्दी 	कुख्यात, कलङ्कित				
बदनामी	फारसी+हिन्दी 	अपयश, कलङ्क, निन्दा, अपमान				
बदनीयत	फारसी+अरबी	दुष्ट, दुष्टाभिप्राय, 		बदनीयतों		
बददुआ  	फारसी+अरबी	दुष्कामना, शाप, 		बद्दुआ, बददुआ, बद्दूआ		
बदसलूकी	अरबी+फारसी	दुर्व्यवहार				
बदहाली	अरबी+फारसी	दुर्दशा				
बदबू	फारसी	दुर्गंध				
बदमाश	अरबी+फारसी	दुष्ट, गुण्डा, दुराचारी		बदमाशों		
बदमाशी	अरबी+फारसी	दुष्टता, दुष्कर्म, कुकर्म, व्याभिचार		बदमाशियों, बदमाशियां		
बदला	अरबी	वैर, प्रतिकार, वैरशुद्धि, परिवर्तित किया				
बदौलत	अरबी+फारसी	कृपा से				
बंदगी	फारसी	सेवा, उपासना, प्रणाम, आराधना,				
बन्दरगाह 	फारसी	नौकाशय, पोताश्रय, 		बंदरगाह		
बंदा	फारसी	भक्त, सेवक		बंदे, बन्दे, बन्दा		
बंदिश	फारसी	बन्धन, यंत्रण		बंदिशे, बंदिशें		
बंदूक	अरबी	???				
बंदोबस्त	फारसी	प्रबंध, व्यवस्था				
बनाम	फारसी	विरुद्ध, की तुलना में				
बम्पर्	आङ्ग्लभाषा	भरपूर	bumper	बम्पर, बंपर		
बयां	अरबी	व्यक्त		बयाँ		
बयान	अरबी	वक्तव्य		बयानों		
बयाना	अरबी+फारसी	अगाऊ				
बयानबाजी	अरबी+फारसी	???				
बर्दाश्त	फारसी	सहन, स्वीकार्य		बरदाश्त, बर्दास्त, बरदास्त		
बर्फ	फारसी	हिम				
बर्बाद	फारसी	नष्ट, ध्वंस, व्यय		बरबाद		
बर्बादी	फारसी	विनाश, पतन, क्षय, व्यय		बरबादी		
बरामद	फारसी	???				
बरकत	अरबी	वृद्धि, लाभ, अनुग्रह, कृपा	بركات			
बरकरार	फारसी	यथावत्, अखण्ड				https://en.wikipedia.org/wiki/Barakat
बरख़ास्त	फारसी	पदच्युत, समाप्त, 		बर्खास्त 		
बल्कि	फारसी	किन्तु, अपितु,				
बवासीर	अरबी	मूलव्याधि, अर्शरोग		बावासीर		
बशर्ते	अरबी+फारसी	???				
बशीर	अरबी	शुभसन्देशवाहक				
बसर	फारसी	निर्वाह				
बहरहाल	अरबी+फारसी	तो भी, यद्यपि				
बहस	अरबी	तर्क-वितर्क, वाद-विवाद, चर्चा,		बहसों		
बहादुर	तुर्की	वीर, साहसी, शूरवीर				
बहादुरी	तुर्की	वीरता, साहस				
बहिश्त	फारसी	स्वर्ग				
बाइज्जत	फारसी	सम्मानपूर्वक, आदर सहित				
बाकमाल	फारसी+अरबी	चमत्कारी		बाँकमाल		
बाकायदा	अरबी	नियमानुसार				
बाग़	फारसी	वाटिका, उपवन, उद्यान				
बाज़ार	फारसी	हाट, मण्डी				
बाजारू	फारसी	???		बाजारु		
बाजी	फारसी	दाँव				
बाद	अरबी	पश्चात, अनन्तर				
बादशाह	फारसी	राजा, सम्राट		बादशाहो, बादशाहों		
बाबा	अरबी	पितामह, साधु,				
बायो	आङ्ग्लभाषा	जैव, जैविक	bio			
बारहा	फारसी	प्रायः				
बारिश	फारसी	वर्षा, मेघ		बारिशों, बारिशें, बारिशो, बारिशे		
बावजूद	अरबी+फारसी	उपरान्त, यद्यपि, बाद भी		बावज़ूत, बाबजूद, बावजुद		
बिग	आङ्ग्लभाषा	विशाल, महत, बडा,	big			
बिज्नेस्	आङ्ग्लभाषा	व्यवसाय, व्यापार, कार्य, 	business	बिजनेस 		
बिज्नेस्मैन्	आङ्ग्लभाषा	व्यवसायी, व्यापारी, 	businessman	बिजनेसमैन 		
बिरादरी	फारसी	जाति, बन्धुत्व				
बिल्कुल	अरबी	पूर्ण रूप से, नितान्त, अवश्य		बिलकुल		
बिल्डिंग्	आङ्ग्लभाषा		building 	बिल्डिंग, बिल्डिंग्स		
बिस्तर	फारसी	शय्या				
बिसात	अरबी	सामर्थ्य, धन, वित्त				
बीमार	फारसी	रोगी, अस्वस्थ				
बीमारी	फारसी	रोग		बीमारियों, बीमारियाँ, बीमारियो, बीमारियां		
बीवी	फारसी	पत्नी, भार्या		बीबी, बीवियों, बीवियां		
बुकचा	तुर्की	गठरी, पोटली,		बुगचा		ब
बुखार	अरबी+फारसी	ज्वर, ताप				1. कपड़े की गठरी 2. बंडल; गठरी; बुगचा।
बुज़दिल	फारसी	डरपोक, भीरु				
बुजुर्ग	फारसी	वृद्ध, वयोवृद्ध		बुजुर्गों, बुजुर्गो		
बुनियाद	फारसी	आधार, जड़, मूल, आरम्भ				
बुनियादी	फारसी	मूलभूत, आरम्भिक				
बुलंद	फारसी	उच्च, उन्नत, प्रबल		बुलन्द		
बुलंदी	फारसी	ऊंचाई				
बुलंदियां	फारसी	उच्चाइयां		बुलंदियों, बुलन्दियां, बुलन्दियों		
बू	फारसी	गन्ध, दुर्गंध				
बेअसर	फारसी	प्रभावहीन, प्रभावशून्य				
बेआवाज़	फारसी	मूक, मौन, नीरव				
बेइज्जत	अरबी	अपमानित, तिरस्कृत		बेज्जत		
बेइज्जती	अरबी	अपमान, तिरस्कार, अनादर		बेज्जती		
बेइंतहा	अरबी+फारसी	अत्यन्त, असीम		बेइंतिहा, बेइन्तहा, बेइन्तिहा, बेइंतेहा, बेइन्तेहा, बेईंतिहा, बेईन्तहा, बेईन्तिहा, बेईंतेहा, बेईन्तेहा,		
बेइंसाफी	अरबी	अन्याय		बेइन्साफी		
बेइमान	अरबी	कपटी, प्रवञ्चक, कुटिल, भ्रष्ट		बेईमान		
बेईमानी	अरबी	कपट, प्रपञ्च, कुटिलता		बेइमानी		
बेक़रार	अरबी+फारसी	व्याकुल, अशांत, उद्विग्न, व्यग्र, उत्सुक				
बेकरारी	अरबी+फारसी	व्याकुलता, अशान्ति, उद्विग्नता, व्यग्रता, उत्सुकता				
बेकाबू	फारसी+तुर्की	अनियंत्रित, निरंकुश		बेकाबु		
बेकार	फारसी	व्यर्थ				
बेख़ौफ़	अरबी	निर्भय, निडर		बेखोफ		
बैरक	तुर्की	विजयध्वज				
बेखबर	फारसी+अरबी	अनजान, असावधान, अनभिज्ञ				
बेगम	तुर्की	पत्नी, रानी,				
बेगाना	फारसी	पराया		बेगानी, बेगाने		
बेगानापन	फारसी	???				
बेगुनाह	फारसी	निर्दोष, निरपराध		बेगुनाहों		
बेग़ैरत	अरबी+फारसी	निर्लज्ज				
बेचारा	फारसी	निःसहाय, निराश्रय, दुर्बल		बेचारे, बेचारों, बेचारी		
बेचैन	फारसी	व्याकुल, अशान्त, उद्विग्न, व्यग्र, उत्सुक		बैचेन, बेचैनियों, बेचैनियां		
बेजुबान	फारसी	मूक, मौन, निर्वाक		बेज़बान, बेजुबानों		
बेजोड	फारसी+हिन्दी	अतुलनीय, अप्रतिम				
बेतकल्लुफ	फारसी+अरबी	आत्मीय, सहज, नि:सङ्कोच				
बेतरतीब	अरबी+फारसी	अव्यवस्थित, अस्तव्यस्त, क्रमविहीन, अनियमित				
बेतरतीबी	अरबी+फारसी	अस्तव्यस्तता, क्रमहीनता, विश्रृंखलता, अनियमितता				
बेदखल	अरबी	गतस्वामित्व, पूर्वस्वामित्व				
बेदम	फारसी	निर्बल, अशक्त, मृतप्राय, 				
बेदर्द	फारसी	निर्दय, कठोर, संवेदनहीन, निर्मम, निष्ठुर				
बेदर्दी	फारसी	निर्दयता, कठोरता, संवेदनहीनता				
बेदाग़	फारसी	स्वच्छ, पवित्र				
बेनक़ाब	अरबी	उजागर				
बेनाम	फारसी+हिन्दी	नामहीन, अप्रसिद्ध, अप्रतिष्ठित				
बेनामी	फारसी+हिन्दी	नामहीन				
बेपनाह	फारसी	निराधार, निराश्रित, शरणहीन				
बेपरवाह	अरबी+फारसी	निश्चिन्त, चिन्तारहित				
बेफिक्र	अरबी+फारसी	निश्चिन्त, चिन्तारहित		बेफ़िकर		
बेफ़िक्री	अरबी+फारसी	निश्चिन्तता				
बेबस	फारसी+हिन्दी	विवश, निःसहाय, निरुपाय				
बेबसी	फारसी+हिन्दी	विवशता, परवशता,				
बेबाक	फारसी	स्पष्टभाषी, ऋणमुक्त, निर्भय, निर्लज्ज				
बेबाकी	फारसी	निर्भयता, निडरता, धृष्टता, निर्लज्जता				
बेमतलब	फारसी+अरबी	निरर्थक, व्यर्थ, अनावश्यक, मिथ्या				
बेमन	फारसी+हिन्दी	बिना मन के, अनिच्छा, अरुचि				
बेमिसाल	अरबी	अद्वितीय, अनुपम				
बेमेल	फारसी+हिन्दी	भिन्न				
बेमौसम	फारसी	असामयिक, अनवसर, अनार्तव				
बेरंग	फारसी+हिन्दी	रंगहीन				
बेरहम	अरबी	निर्दयी, निष्ठुर, निर्मम				
बेरहमी	अरबी	निर्दयता				
बेरुख	फारसी	अप्रसन्न		बेरूख		
बेरुखी	फारसी	अप्रसन्नता		बेरूखी		
बेरोजगार	फारसी	अनुर्वर		बेरोजगारों		
बेरोजगारी	फारसी	अनुर्वता				
बेलगाम	फारसी	अनियन्त्रित, निरङ्कुश				
बेलिबास	फारसी+अरबी	नग्न				
बेवक्त	अरबी+फारसी	अकाल, कुसमय, असमय				
बेवक़ूफ़	अरबी	अज्ञानी, मूर्ख, निर्बुद्धि		वेवकूफ, बेवकूफों, बेवकुफ, बेवकुफो, बेवकुफों		
बेवकूफी	अरबी	मूर्खता, बुद्धिहीनता		बेवकूफियों, बेवकूफियां		
बेवजह	अरबी	अकारण				
बेवफ़ा	अरबी+फारसी	कृतघ्न, द्रऋही, विश्वासघाती				
बेवफाई	अरबी+फारसी	विश्वासघात				
बेशक	अरबी	निःसन्देह, अवश्य, नि:संशय				
बेशकीमती	अरबी+फारसी	बहुमूल्य				
बेशर्म	फारसी	निर्लज्ज		बेशरम, बेशर्मोँ, बेशर्मों,		
बेशर्मी	फारसी	निर्लज्जता				
बेशर्मियत	फारसी	निर्लज्जता		बेशरमियत, बेशर्मीयत		
बेशुमार	फारसी	अगणित, असङ्ख्य				
बेस्ट्	आङ्ग्लभाषा	सर्वश्रेष्ठ, उत्तम	best	बेस्ट		
बेसब्री	अरबी	व्याकुलता				
बेसबब	अरबी+फारसी	अकारण				
बेसहारा	फारसी+हिन्दी 	असहाय, निःसहाय, निराश्रय				
बेहतर	फारसी	उचित, अच्छा				
बेहतरीन	फारसी	उत्तम, श्रेष्ठ				
बेहद	अरबी	अत्यन्त, असीम, अपार, अनन्त				
बेहाल	अरबी+फारसी	व्याकुल, दुर्दशाग्रस्त, अचेत				
बेहिसाब	अरबी+फारसी	अत्याधिक, अगणित				
बेहूदापन	???	अशिष्टता, असभ्यता				
बेहूदगी	???	अशिष्टता, असभ्यता				
बैन्	आङ्ग्लभाषा	प्रतिबन्ध		बैन		
बोडी	आङ्ग्लभाषा	देह, शरीर	body	बॉडी 		
बोय	आङ्ग्लभाषा	लडका, कुमार, बालक, पुत्र, माणव, 	boy		^ब(ो|ॉ)य(्)?(ज्|ज)?$	
बोरियत	आङ्ग्लभाषा	नीरसता, उदासी, विरक्ति				
बैंक्	आङ्ग्लभाषा	अभिकोष, तीर, तट,वित्तकोष		बैंक		
बेहोश	फारसी	अचेत, चेतनाहीन, मूर्छित				
बैरिस्टर्	आङ्ग्लभाषा	अधिवक्ता, अभिभाषक, प्रतिनिधि	barrister 	बैरिस्टर		
						
भरोसेदार	हिन्दी+फारसी	विश्वसनीय , निष्ठावान				
भरोसेमंद	हिन्दी+फारसी	विश्वसनीय , निष्ठावान				
भागीदार	हिन्दी+फारसी	सहभागी				
						
मक्कार	अरबी	कपटी, धूर्त		मक्कारों		
मक्कारी	अरबी	कुटिलता, धूर्तता, कपट, छल		मक्कारियां, मक्कारिया		
मक़सद	अरबी	उद्देश्य, प्रेरणा, हेतु				
मकान	अरबी	घर, गृह, निवास स्थान, भवन				
मक़ाम	अरबी	पड़ाव, स्थान, विराम, घर				
मखदूम	अरबी	पूज्य, पूजनीय, मान्य, स्वामी, 				
मग़्फ़िरत	अरबी	???		मगफिरत		
मगर	फारसी	किन्तु, परन्तु				
मगरूर	अरबी	अभिमानी, अहंकारी				
मजदूर	फारसी	श्रमिक		मजदूरों		
मजदूरी	फारसी	श्रम, परिश्रम				
मजबूत	अरबी	दृढ़, शक्तिशाली, सशक्त				
मजबूती	अरबी	सुदृढ़ता, बलशालिता, शक्तिमत्ता				
मजबूर	अरबी	विवश, निःसहाय		मजबुर		
मजबूरन	अरबी	विवशतापूर्वक, विवशतावश		मजबुरन		
मजबूरी	अरबी+फारसी	विवशता, निःसहायता		मजबूरियां, मजबूरियाँ, मजबूरियों		
मजलूम	अरबी	पीडित, त्रस्त, 		मजलूमों		
मजलिस	अरबी	सभा, अधिवेशन, सभास्थल ,				
मज़हब	अरबी	पंथ				
मजा	फारसी	आनन्द, हर्ष, आह्लाद, प्रमोद				
मजाक	अरबी	परिहास				
मजाल	अरबी	चेष्टा, दुस्साहस				
मजिस्ट्रेट्	आङ्ग्लभाषा	न्यायाध्यक्ष, न्यायाधिपति, दण्डप्रणेता, दण्डनायक, 	magistrate 	मजिस्ट्रेट		
मजेदार	फारसी	रोचक , मनोरञ्जक , सुखदायी				
मद्देनजर	अरबी	दृष्टि समक्ष, दृष्टिगत, ध्यान में रखकर				
मतलब	अरबी	अर्थात्, अभिप्राय, उद्देश्य, स्वार्थ, सम्बन्ध, अर्थ, तात्पर्य				
मतलबी	अरबी	स्वार्थी				
मदद	अरबी	सहाय, सहायता		मदत		
मददगार	अरबी	सहायक				
मंजर	???	दृश्य		मन्जर		
मंज़िल	अरबी	लक्ष्य, गन्तव्य, दिशा, विश्रामस्थल		मंजिलों, मंजिलें, मंजिले, मन्ज़िल		
मंजूर	अरबी	स्वीकृत, स्वीकार्य		मन्जुर,मन्जूर, मंजुर		
मंजूरी	अरबी+फारसी	स्वीकृति, अनुमति		मंजुरी, मन्जूरी, मन्जुरी		
मंसूबा	अरबी	योजना, युक्ति, उपाय, सङ्कल्प		मंसूबों, मंसूबो, मंसूबे, मंसूबें, मन्सूबा, मन्सूबों, मन्सूबो, मन्सूबे, मन्सूबें		
मन्नत	फारसी	मनोकामना, संकल्प				
मनपसंद	उर्दू	रुचिकर, प्रिय		मनपसन्द		
मनहूस	अरबी	अशुभ				
मय्यत	अरबी	मृतक, शव		मय्यतें		
मयख़ाना	फारसी	मदिरालय				
मयस्सर	???	उपलब्ध				
मर्ज़ी	अरबी	इच्छा, अभिलाषा, कामना, मनोरथ, आकांक्षा				
मर्डर्	आङ्ग्लभाषा	हत्या		मर्डर		
मर्तबा	अरबी	वार, बार		मरतबा		
मर्द	अरबी	पुरुष, मानव, नर, पति	مرد	मरद		
मर्दानगी	अरबी	पौरुष, साहस		मरदानगी		
मर्दानी	अरबी	पौरुषवान, साहसी		मरदानी		
मरज़	अरबी	रोग		मर्ज		
मरम्मत	अरबी	पुनर्निर्माण, जीर्णोद्धार, मारना		मरम्मते, मरम्मतें		
मरहम	अरबी	औषधि				
मरहूम	अरबी	मृत, दिवंगत				
मरासिम	अरबी	???				
मरीज़	अरबी	रोगी, अस्वस्थ		मरीजों		
मलाल	अरबी	दुःख, पश्चाताप, उदासीनता				
मवाली	अरबी					
मशक्कत	अरबी	परिश्रम, कष्ट,				
मशविरा	अरबी	परामर्श, मंत्रणा				
मशहूर	अरबी	प्रसिद्ध, सुप्रसिद्ध, प्रख्यात, विख्यात		मशहुर		
मशिय्यत	???	ईश्वरेच्छा		मशिय्यतों		
मशीन	आङ्ग्लभाषा	यंत्र		मशीनें, मशीने		
मस्त	फारसी	तल्लीन, उत्तम ,				
मस्ती	फारसी	मद, उन्मत्त, अभिमान				
मस्तूल	पुर्तगाली	???				
मसख़रा	अरबी	विदूषक		मसखरे, मसखरों		
मसखरी	अरबी	हास्य विनोद, उदाहरण				
मसला	अरबी	समस्या, मुद्दा		मसलों, मसले		
मसर्रत	अरबी	आनन्द, हर्ष, प्रसन्नता				
मसरूफ़	अरबी	व्यस्त, कर्म्मोद्युक्त		मसरुफ़		
मसरूफ़ियत	अरबी	व्यस्तता		मसरुफ़ियत		
मसीहा	अरबी	देवदूत		मसीह		
मसौदा	अरबी	प्रारूप,				
महकमा	अरबी	न्यायालय, आदेशालय				
महज	अरबी	मात्र, केवल				
महदूद	अरबी	सीमित, निश्चित, सीमाबद्ध				
महफ़िल	अरबी	सभा, समारोह		महफिलो, महफिलों, महफ़िलें, महफ़िले		
महफूज	अरबी	रक्षित, सुरक्षित,				
महबूब	अरबी	प्रिय, प्रेमी				
महरूम	अरबी	अभागा, वञ्चित				
महल्ला	अरबी	???		मोहल्ला, मौहल्ला, महल्ले, मुहल्ले, मोहल्ले		
महल	अरबी	राजभवन		महलो, महलों,		
महसूस	अरबी	अनुभव, प्रतीत		मह्सूस, महसुस		
माइनोरिटी	आङ्ग्लभाषा	अल्पसङ्ख्यक	minority 	माइनॉरिटी		
माकूल	अरबी	यथेष्ट, उचित, योग्य, उत्तम				
माजरा	अरबी	घटना				
मातम	अरबी	मृत्युशोक				
माफ	अरबी	क्षमा		मुआफ		
माफी	अरबी	क्षमा		मांफी		
मामला	अरबी	घटना, विषय		मामलात		
मामले	अरबी	घटना, विषय		मामले, मामलें, मामलों, मामलो		
मामूली	अरबी+फारसी	साधारण				
मायूस	अरबी	निराश, हताश, उदास				
मायूसी	अरबी	निराशा, हताशा, उदासी		मायूसियों, मायूसियां		
मार्स्	आङ्ग्लभाषा	मङ्गल	mars	मार्स		
मारूफ़	अरबी	प्रसिद्ध				
माल	अरबी	धन, सम्पत्ति, सामग्री				
मालगुज़ारी	अरबी+फारसी	भूमिकर, भूराजस्व, लगान				
मालिक	अरबी	स्वामी, अधिपति		मालिकों,		
मालूम	अरबी	ज्ञात, विदित				
माशूका	अरबी	प्रेमिका, प्रेयसी				
मासूम	अरबी	निर्दोष, निरपराध	معصوم	मासूमों		
मासूमियत	अरबी	निर्दोषिता, निष्कपटता				
माहिर	अरबी	विशेषज्ञ, प्रवीण, निपुण, दक्ष				
माहौल	अरबी	वातावरण, स्थिति		माहोल		
मिज़ाज	अरबी	प्रकृति, स्वभाव, गर्व				
मिडल्	आङ्ग्लभाषा	मध्यम	middle 	मिडल , मिडिल, 		
मिनार	अरबी	स्तम्भ		मीनार		
मियाँ	फारसी	पति,		मिया, मियां		
मिरात	अरबी	दर्पण				
मिल्कियत	अरबी	सम्पत्ति				
मिल्की	अरबी	भूस्वामी				
मिल्लत	अरबी	???				
मिशन्	आङ्ग्लभाषा	नियोग, 	mission	मिशन		
मिस्कीन	अरबी	दीन, दुःखी, दरिद्र				
मिस्कीनी	अरबी	दीनता, दरिद्रता				
मिस्ट्री	आङ्ग्लभाषा	रहस्य	mystery 			
मिसवाक	अरबी	धन्तधावन, दातुन				
मिसाल	अरबी	उदाहरण, दृष्टान्त, आदर्श				
मीडिया	आङ्ग्लभाषा	संचार	media			
मुआफिक	अरबी	अनुकूल				
मुआमला	अरबी	विषय, विवाद, अभियोग		मुआमले		
मुआमलादाँ	अरबी	दूरदर्शी				
मुआवजा	अरबी	क्षतिपूर्ति, निष्कृति, प्रतिफल		मुआवजे , मुआवाजा		
मुआशरा	???	???				
मुक्केबाज	हिन्दी+फारसी	???				
मुक्केबाजी	हिन्दी+फारसी	मल्लयुद्ध				
मुकद्दम	अरबी	मुख्य, प्रधान				
मुकद्दर	अरबी	भाग्य				
मुक़द्दस	अरबी	पवित्र, पूज्य				
मुक़दमा	अरबी	अभियोग		मुक़दमे		
मुकर्रर	अरबी	नियुक्त, निश्चित				
मुकर्ररी	अरबी	नियुक्ति				
मुक़म्मल	अरबी	सम्पूर्ण, समाप्त		मुक्कमल		
मुकाबला	अरबी	विरोध, प्रतिस्पर्द्धा, सामना, तुलना,		मुकाबले , मुकाबिला,		
मुकाबिल	अरबी	सम्मुख				
मुक़ाम	अरबी	पड़ाव, स्थान, विराम, घर				
मुख़्तलिफ़	अरबी	भिन्न, विविध	مختلف	मुख़्तलिब		
मुख़्तसर	अरबी	संक्षिप्त, लघु, अल्प, न्यून				
मुख्तार	अरबी	प्रतिनिधि		मुखतार, मूख्तार, मूखतार		
मुखबिर	अरबी	गुप्तचर				
मुखालफत	अरबी	विरोध				
मुख़ालिफ़	अरबी	विरोधी, शत्रु				
मुचलका	तुर्की	???				
मुज़क्कर	अरबी	पुल्लिङ्ग, नर, पुरुष				नियत तिथि पर हाज़िर होने का प्रतिज्ञा पत्र जिसका पालन न होने पर प्रतिज्ञा करने वाला निर्धारित अर्थदंड देना स्वीकार करता है।
मुजरिम	अरबी	अपराधी, दोषी		मुजरिमो, मुजरिमों, मुज्रिमो, मुज्रिम		
मुत्तहिद	अरबी	संयुक्त				
मुतलाशी	अरबी	अन्वेषक				
मुताबिक़	अरबी	अनुसार				
मुद्दत	अरबी	समय, अवधि		मुद्दतें, मुद्दते		
मुद्दा	अरबी	विषय, अभिप्राय, आशय, उद्देश्य		मुद्दे		
मुदस्सिर	अरबी	???	مُدَثِّر			
मुंतजर	अरबी	प्रतीक्ष्य		मुन्तजर		
मुंतजिर	अरबी	प्रतीक्षक		मुन्तजिर		
मुंतशिर	अरबी	अस्तव्यस्त, उद्विग्न				
मुनाफ़ा	अरबी	लाभ, हित, अर्जन		मुनाफे		
मुनासिब	अरबी	उचित				
मुफ़्त	अरबी	निःशुल्क		मूफ़्त		
मुफ्तखोर	अरबी+फारसी	परोपजीवी, परान्नभोजी, कामचोर		मुफ्तखोरों ,मुफ्तखोरो		
मुफ्तरी	अरबी	धूर्त				
मुबारक	अरबी	अभिनन्दन, शुभकामनाए				
मुबारकबाद	अरबी+फारसी	शुभकामना				
मुबारका	अरबी	???				
मुमकिन	अरबी	सम्भव				
मुमकिनात	अरबी	सम्भावनाएँ				
मुल्क	अरबी	देश, प्रदेश		मुल्कों		
मुर्गीपालन 	फारसी+संस्कृत	???				
मुर्गी 	फारसी	कुक्कुटी		मुर्गियों,  मुरगी, 		
मुर्दा	फारसी	मृत, शव, निष्प्राण, प्राणहीन		मुरदा, मुर्दे		
मुर्दाबाद	फारसी	मृत्यु हो		मुरदाबाद, मूर्दाबाद		
मुरब्बा	अरबी	???				
मुरव्वत	अरबी	संकोच, लज्जा		मुरौवत, मुरुव्वत		
मुलाकात	अरबी	बैठक, मिलन, भेंट, साक्षात्कार		मुलाकाते, मुलाकातें, मुलाकातो, मुलाकातों		
मुलाजिम	अरबी	कर्मचारी, सेवक		मुलाजिमों		
मुलायम	अरबी	कोमल , मृदु				
मुश्क	फारसी	कस्तूरी		मिश्क		
मुश्किल	अरबी	कठिन, कठिनाई		मुश्किले, मुश्किलें, मुश्किलो, मुश्किलों, मुशकिल		
मुश्तरक	अरबी	संयुक्त				
मुशायरा	अरबी	कविसम्मेलन		मुशायरे, मुशायरें		
मुस्तैद	अरबी	तत्पर, कटिबद्ध, सन्नद्ध				
मुस्तैदी	अरबी	तत्परता, कटिबद्धता, सन्नद्धता				
मुसलसल	अरबी	निरन्तर, सतत, अनवरत				
मुसाफिर	अरबी	यात्री, पथिक		मुसाफिरों		
मुसीबत	अरबी	कष्ट, सङ्कट, विघ्न, विपत्ति		मुसीबतों, मुसीबतें, मुसीबतो, मुसीबते		
मुहज़्ज़ब	अरबी	शिष्ट, सभ्य, शिक्षित, सुसंस्कृत		मोहज्ज़ब		
मुहताज	अरबी	आश्रित, पराधीन, निर्भर		मोहताज		
मुहर	फारसी	मुद्रा, चिन्ह				
मुहाजिर	अरबी	देशान्तराधिवासी, देशागत, आप्रवासी				
मुहाफजत	अरबी	रक्षा				
मुहाफ़िज़	अरबी	रक्षक, संरक्षक, निरीक्षक ।				
मुहावरा	अरबी	रूढ़ि प्रयोग, अभ्यास				
मुहिम	अरबी	सङ्घर्ष, अभियान, आन्दोलन		मुहीम		
मुहैया	अरबी	प्रस्तुत, उपस्थित, उपलब्ध,				
मूवी	आङ्ग्लभाषा	चलचित्र, 	movie 			
मेडल्	आङ्ग्लभाषा	पदक 	medal	मेडल्स,  मेडल 		
मेडिकल्	आङ्ग्लभाषा	वैद्य, औषधीय, वैद्यशास्त्र, वैद्यशास्त्रीय	medical	मेडिकल		
मेसेज्	आङ्ग्लभाषा	सन्देश	message 	मेसेज, मेसेजिस		
मेहनत	अरबी	परिश्रम		महेनत		
मेहनती	अरबी+फारसी	परिश्रमी		महेनती		
मेहमाननवाज़ी	फारसी	अतिथिसत्कार				
मेहर	फारसी	कृपा, दया				
मेहरबान	फारसी	दयालू, कृपालु		महेरबान		
मेहरबानी	फारसी	दया, कृपा		महेरबानी		
मैग्नोलिया	आङ्ग्लभाषा	चम्पा		मैगनोलिया		
मैच्	आङ्ग्लभाषा	तुलना,  स्पर्धा, समतोल, विवाहघटन, 	match	मैच 		
मैदान	फारसी	क्षेत्र, भूमि, विस्तार, रणभूमि		मेदान		
मैन्	आङ्ग्लभाषा	मनुष्य,  पुरुष,  	man	मैन		
मैनेज्	आङ्ग्लभाषा	प्रबन्धन, सञ्चालन	manage	मैनेज		
मैनेजमेंट्	आङ्ग्लभाषा	प्रबन्धन	management 	मेनेजमेंट, मैनेजमेन्ट		
मैनेजर्	आङ्ग्लभाषा	प्रबन्धक	manager	मैनेजर		
मैप्	आङ्ग्लभाषा	मानचित्र	map	मैप्स, मैप		
मोमेंटम्	आङ्ग्लभाषा	वेगमान	moment 	मोमेंटम		
मोर्निंग्	आङ्ग्लभाषा	प्रभात 	morning 	मॉर्निंग, मार्निंग,  मोर्निंग 		
मोहब्बत	अरबी	प्रेम, प्रीति, स्नेह		मोहब्बतों, मोहब्बतें, मोहोबत, मुहब्बत, मोहब्बते, महोबत, महोब्बत		
मोहर	फारसी	मुद्रा		मुहर		
मोहलत	अरबी	अवधि, अवकाश, समय				
मौका	अरबी	अवसर, अवधि, अवकाश		मौके, मौको, मौकें, मौकों		
मौज	अरबी	तरङ्ग, उमङ्ग, आनन्द, सुख,				
मौजूद	अरबी	उपस्थित, समक्ष, प्रस्तुत, विद्यमान				
मौजूदा	अरबी	वर्तमान, उपस्थित, प्रस्तुत				
मौजूदगी	अरबी	उपस्थिति, समक्षता				
मौत	अरबी	मृत्यु, निधन, अवसान, देहत्याग		मौते, मौतों, मौतें		
मौसम	अरबी	ऋतु, काल, समय		मौसिम		
						
यकायक	फारसी	अचानक				
यकीन	अरबी	विश्वास		यकिन		
यकीनन	अरबी	निःसन्देह				
यतीम	अरबी	अनाथ				
यलगार	तुर्की	आक्रमण				
याद	फारसी	स्मरण, स्मृति	یاد	यादें, यादो, यादों, यादे		
यादगार	फारसी	अविस्मरणीय, स्मारक, स्मृतिचिह्न				
याददाश्त	फारसी	स्मरणशक्ति, स्मृति		याद्दाश्त		
यानी	अरबी	अर्थात्		याने, यानि		
यार	फारसी	मित्र				
याराना	फारसी	मैत्री, मित्रता		याराने		
यारी	फारसी	मैत्री, मित्रता		यारीयां, यारीया		
यारों	फारसी	मित्रों		यारो		
याल	तुर्की	ग्रीवा				
यूझर	आङ्ग्लभाषा	उपभोक्ता , उपयोगकर्ता	user	यूजर		
यूनिट्	आङ्ग्लभाषा	एकाङ्क, मात्रा, विभाग, भाग	unit	यूनिट		
यूनिटी			unity	युनिटी, यूनीटी, युनीटी, यूनिटि, युनिटि, यूनीटि, युनीटि, 	^य(ु|ू)न(ि|ी)ट(ि|ी)$	
यूनिवर्सिटी	आङ्ग्लभाषा	विश्वविद्यालय	university 	युनिवर्सिटी		
यौम	अरबी	दिवस				
						
रईस	अरबी	धनी, धनवान,		रइस		
रईसजादा	अरबी+फारसी	???		रईसजादी, रईसजादे, रईसजादो, रईसजादों		
रक़म	अरबी	अंक, धन, संपत्ति		रक्म		
रकीब	अरबी	प्रतिद्वन्दी, प्रतिस्पर्धी, शत्रु, रक्षक				
रद्द	अरबी	निरस्त				
रंज	फारसी	दुःख,आघात, अप्रसन्नता, विषाद				
रंजिश	फारसी	वैमनस्य, अप्रसन्नता, वैर, दुर्भावना		रंजिशें		
रफ़्तार	फारसी	गति, प्रगति				
रफूचक्कर	अरबी+हिन्दी	पलायित, चंपत				
रब	अरबी	ईश्वर, भगवान्				
रवाँ	फारसी	अभ्यस्त, प्रवाहित, तीक्ष्ण				
रवाना	फारसी	प्रस्थान, प्रस्थित, अपगम्				
रवानी	फारसी	प्रवाह, बहाव, धारा				
रवैया	फारसी	वृत्ती, आचार, व्यवहार		रवैये , रवैए		
रस्म	अरबी	प्रथा, विधि, समारोह		रस्मो, रस्मों, रस्मे, रस्में		
रसूख़	अरबी	प्रभाव				
रहम	अरबी	दया, करुणा, कृपा				
रहमदिल	अरबी+फारसी	दयालू, कृपालु, करुणामय,				
रहमत	अरबी	कृपा				
राजी	अरबी	तत्पर, संतुष्ट, सहमत, प्रसन्न				
राब्ता	अरबी	मिलन, सम्पर्क, सम्बन्ध, 		रवाबित, राबता, 		
राशन	आङ्ग्लभाषा	किराना, खाद्य	ration			
रास्ता	फारसी	मार्ग		रास्तों, रास्तो, रास्ते, रस्ता, रस्ते		
राह	फारसी	मार्ग		राहों, राहें		
राहगीर	फारसी	यात्री, पथिक		राहगीरों, राहगीरो		
राहत	अरबी	सहायता, भारमुक्ति				
राही	फारसी	यात्री, पथिक				
रिक्वेस्ट	आङ्ग्लभाषा	विनती, प्रार्थना	request 			
रिकशा	जापानी	???				
रिजर्व्	आङ्ग्लभाषा	संरक्षित, निग्रह, संग्रह, विनिग्रह, 	reserve	रिजर्व 		
रिज़ल्ट	आङ्ग्लभाषा	परिणाम	result			
रिजीम	आङ्ग्लभाषा	शासन, व्यवस्था	regime 			
रिपोर्ट	आङ्ग्लभाषा	प्रतिवेदन, विवरण	report	रिवाजों,		
रिपैर्	आङ्ग्लभाषा	जीर्णोद्धार, सुस्थ, क्षतिपूरण, ठीक, सम्यक्, 	repair 		^र(ि|ी)प(ेै|ेय)र(्)?$	
रिफ़्यूजी	आङ्ग्लभाषा	शरणार्थी	refugee 	रिफ्यूजीओं, रिफ्यूजीओ , रेफ्यूजी		
रियाज	अरबी	अभ्यास, तपस्या, 				
रियायत	अरबी	छूट		रिआयत, रियायतें		
रियासत	अरबी	राज्य, वैभव, शासन		रियासतें, रियासतों, रियासते		
रियासतकालीन	अरबी+हिन्दी	???				
रिलीज्	आङ्ग्लभाषा	मोचन, मुक्ति, प्रदर्शन, प्रकाशन, 	release 		^र(ि|ी)ल(ि|ी)ज(्)?$	
रिवाज	अरबी	प्रथा, प्रणाली, परम्परा				
रिश्ता	फारसी	सम्बन्ध		रिश्ते, रिश्तों, रिश्तो		
रिश्तेदार	फारसी	सम्बन्धी		रिश्तेदारों, रिस्तेदार, रिस्तेदारो		
रिश्तेदारी	फारसी	सम्बन्ध				
रिश्वत	अरबी	घूस, उत्कोच, भ्रष्टाचार				
रिस्क	आङ्ग्लभाषा	जोखिम , सङ्कट, विपत्ति	risk			
रिसर्च 	आङ्ग्लभाषा	अनुसन्धान , अन्वेषण,  शोध,  	research 			
रिहा	फारसी	मुक्त				
रिहाई	फारसी	मुक्ति, छुटकारा				
रिफॉर्म्स	आङ्ग्लभाषा	सुधार, दोषनिवृत्ति	reform 			
रुख़	फारसी	मुख, अभिवृत्ति				
रुख़सत	अरबी	आज्ञा, प्रस्थान, अवकाश		रूखसत, रुखशत, रूखशत		
रुझान	अरबी	???		रूझान		
रुतबा	अरबी	प्रतिष्ठा		रुतबे , रूतबा, रूतबे		
रुमाल	फारसी	करवस्त्र		रूमाल		
रुसवा	फारसी	अपमानित, कलङ्कित				
रुसवाई	फारसी	अपयश, कलङ्क, निन्दा, अपमान		रुसवाईयाँ, रुसवाईयां, रुसवाईया		
रूमानी	???	अद्भुतप्रिय, मनोहर, हृदयग्राही				
रूमानियत	???	???				
रूबरू	फारसी	समक्ष		रुबरु, रुबरू		
रूह	अरबी	आत्मा, अन्तःकरण, चित्त		रूहें, रूहों,		
रूहानी	अरबी	आत्मिक, आध्यात्मिक				
रेकोर्ड्	आङ्ग्लभाषा	कीर्तिमान, अभिलेख,  	record 	रिकार्ड,  रिकॉर्ड,  रेकोर्ड, रेकॉर्ड्स, रेकोर्ड्स, रेकोर्ड्स्		
रेगिस्तान	फारसी	मरुस्थल, मरुभूमि				
रेड्	आङ्ग्लभाषा	रक्त, लोहित, रोहित, शोणित, रक्तवर्ण, अरुण, 	red	रेड		
रेडिएशन्	आङ्ग्लभाषा	विकिरण, 	radiation 	रेडिएशन		
रेप	आङ्ग्लभाषा	बलात्कार	rape			
रेलेवेंट	आङ्ग्लभाषा	प्रासङ्गिक, उचित, सुसङ्गत	relevant 	रेलेवेन्ट, रिलेवंट,		
रेस्क्यू	आङ्ग्लभाषा	बचाव	rescue 			
रेस्तराँ	फ्रेंच	भोजनालय	restaurant 			
रेस 	आङ्ग्लभाषा	स्पर्धा, दौड, प्रजाति, जाति,  	race			
रेसलर	आङ्ग्लभाषा	 मल्ल 	wrestler 			
रोड	आङ्ग्लभाषा	सड़क, मार्ग, पथ	road			
रोज़	फारसी	दिन, प्रतिदिन				
रोज़गार	फारसी	व्यापार				
रोज़मर्रा	अरबी+फारसी	दैनिक, नित्य		रोजमर्रे		
रोजाना	फारसी	प्रतिदिन, दैनिक				
रोशन	फारसी	प्रकाशित, प्रदीप्त, प्रसिद्ध, प्रख्यात				
रोशनी	फारसी	प्रकाश		रौशनी		
						
लकीर	???	रेखा		लकीरों, लकीरो, लकीरें, लकीरे		
लगाम	फारसी	नियन्त्रण, अङ्कुश				
लज़ीज़	अरबी	स्वादिष्ट				
लंग्स्	आङ्ग्लभाषा	फुप्फुस, फेफड़ों	lungs	लंग्स		
लफ्ज़	अरबी	शब्द		लफ्जो, लफ्जों, लफ्जे, लफजों, लब्ज, लब्जो, लब्जों,		
लफंगा	फारसी	दुश्चरित्र, व्यभिचारी, चरित्रहीन		लफंगों, लफंगो, लफंगे		
लबादा	अरबी	???				
लम्हा	अरबी	क्षण, घड़ी		लम्हें, लम्हों, लम्हे		
लश्कर	फारसी	सेना				
लहज़ा	अरबी	ढङ्ग, शैली, लय		लहजे		
लाइलाज	अरबी	असाध्य				
लाइसेंस्	आङ्ग्लभाषा	अनुमति, अनुज्ञा, अनुज्ञाप‍त्र, अधिकार, 	license 		^ला(इ|ई)से(न्|ं)स(्)?$	
लाउड्स्पीकर्	आङ्ग्लभाषा	ध्वनिवर्धक	loudspeeker	लाउडस्पीकर		
लाचार	अरबी+फारसी	विवश, निरुपाय, असमर्थ		लाचारों		
लाचारी	अरबी+फारसी	विवशता, निःसहायता				
लाजवाब	अरबी	अतुलनीय, अप्रतिम		लाजबाब		
लाज़िम	अरबी	आवश्यक, उचित				
लाजिमी	अरबी	आवश्यक, उचित, अनिवार्य		लाजमी, लाज्मी		
लानत	अरबी	धिक्कार, तिरस्कार		लानते, लानतें,		
लापता	अरबी+हिन्दी	गुप्त, स्थानभ्रष्ट,				
लापरवाह	अरबी+फारसी	असावधान, अविचारी				
लापरवाही	अरबी+फारसी	असावधानी, उपेक्षा				
लाश	फारसी	शव		लाशों, लाशें		
लास्ट	आङ्ग्लभाषा	अन्तिम, गत	last			
लिंचिंग 	आङ्ग्लभाषा	हत्या 	lynching 			
लिबास	अरबी	वेश, परिधान, वस्त्र		लिबाज		
लिमिट	आङ्ग्लभाषा	मर्यादा, सीमा	limit	लीमिट, लिमीट,		
लिस्ट्	आङ्ग्लभाषा	सूची, सूचिपत्र, आवलि, 	list	लिस्ट 		
लिहाज़	अरबी	विचारशीलता, चिन्ता				
लिहाज़ा	अरबी	इसलिए, अतः				
लेकिन	अरबी	परन्तु, किन्तु	لكن	लेकीन		
लॉट	आङ्ग्लभाषा	खेप	lot			
लोर्ड्	आङ्ग्लभाषा	विधाता, भगवान्  सामन्त, शासक, 	lord	लॉर्ड,  लोर्ड 		
लोन्च्	आङ्ग्लभाषा	आरम्भ, चालू, प्रक्षेपण, 	launch	लॉन्च, 		
						
व्हीट	आङ्ग्लभाषा	गेहूँ	wheat			
वक्त	अरबी	समय, काल, वेळा	وقت			
वक्फ	अरबी	दान				
वकालत	अरबी	प्रतिनिधित्व, अभिभाषण, अभिवचन		विकालत		
वकील	अरबी	अधिवक्ता, अभिभाषक, प्रतिनिधि		वकीलों		
वक़ूफ़	अरबी	ज्ञान, बुद्धि				
वज़न	अरबी	भार, बोझ, महत्व				
वजनी	अरबी	भारी				
वजनदार	अरबी+फारसी	भारी				
वजह	अरबी	कारण, हेतु		वजहो, वजहों, वजहें, वजहे, बजह		
वजूद	अरबी	अस्तित्व				
वतन	अरबी	देश, स्वदेश				
वफ़ा	अरबी	निष्ठा		वफ़ाओं, वफाओ, वफ़ाए		
वफ़ात	अरबी	मृत्यु, देहान्त,				
वफादार	अरबी+फारसी	निष्ठावान, निष्ठ,				
वफादारी	अरबी	निष्ठा				
वबा	अरबी	महामारी		वबाएँ, वबाएं		
वर्क्	आङ्ग्लभाषा	कार्य	work	वर्क		
वर्ल्ड्	आङ्ग्लभाषा	विश्व, जगत, संसार	world	वर्ल्ड		
वर्शिप्	आङ्ग्लभाषा	पूजा, आराधना, 	worship 	वर्शिप, वरशिप, 		
वरना	फारसी	अन्यथा, नहीं तो		वर्ना		
वसूल	अरबी	प्राप्त, लब्ध		वसूला		
वसूली	अरबी	प्राप्ति, उगाही				
वहम	अरबी	भ्रम, सन्देह, संशय, शङ्का				
वहशी	अरबी	असभ्य, अभद्र, जङ्गली				
वहशीपन	अरबी	असभ्यता, क्रूरता, पशुता				
वाकई	अरबी	वस्तुतः, वास्तव में,				
वाक़िफ़	अरबी	परिचित, जागरूक				
वादा	अरबी	वचन		वादे		
वादाख़िलाफ़ी	अरबी+फारसी	वचनभङ्ग				
वापस	अरबी	पुनः		वापिस		
वापसी	अरबी	???				
वायरल्	आङ्ग्लभाषा	सङ्क्रामक 	viral	वाइरल, वायरल, 		
वायरस	आङ्ग्लभाषा	विषाणु	virus	वाइरस		
वारदात	अरबी	घटना, दुर्घटना,		वारदातों		
वारंट्	आङ्ग्लभाषा	अधिकारपत्र, आज्ञापत्र, शासनपत्र, अनुज्ञापत्र, 	warrant 	वारंट		
वाहियात	अरबी	व्यर्थ, निरर्थक, मुर्ख, अशिष्ट, दुष्ट				
विजन	आङ्ग्लभाषा	दृष्टि, स्वप्न	vision			
विजनरी	आङ्ग्लभाषा	दूरदर्शी, दीर्घदृष्टा	visionary 			
विरासत	अरबी	पैतृक, उत्तराधिकार, वंशागत				
वास्ते	अरबी	कारण, हेतु, लिए, निमित्त				
वेरिफाइ	आङ्ग्लभाषा	???	verify	वेरिफाई, वेरीफाई, वेरीफाइ	^वेर(ि|ी)फा(इ|ई)(ड|ड्)?$	
वेरियंट्	आङ्ग्लभाषा	प्रकार	variant	वेरिएंट, वेरियंट, वैरियंट		
वेरिफिकेशन्	आङ्ग्लभाषा	???	verification 	वेरिफिकेशन	^वेर(ि|ी)फ(ि|ी)केशन(्|्स्|्स)?$	
वोट	आङ्ग्लभाषा	मत	vote	वोटों		
वोटर	आङ्ग्लभाषा	मतदाता,	voter	वोटर्स		
वोलण्टियर्	आङ्ग्लभाषा	स्वयंसेवक, 	volunteer 		^व(ो|ॉ)ल(े)?(न्|ं|ण्)टयर(्|्स्|्स)?$	
वैक्सीन्	आङ्ग्लभाषा	टीका	vaccine 	वैकसीन, वेक्सीन, वैक्सीन		
वैक्सिनेशन्	आङ्ग्लभाषा	टीकाकरण	vaccination	वैक्सीनेशन, वैक्सिनेशन		
						
शक्ल	अरबी	रूप, मुख, मुखाकृति		शक्लें, शकल		
शक	अरबी	संशय, सन्देह,				
शख्स	अरबी	व्यक्ति		शख्सों, सख्श, शक्स		
शख़्सियत	अरबी	व्यक्तित्व				
शगूफ़ा	फारसी	विलक्षण बात		शिगूफा		
शफाकत	अरबी	कृपा, प्रेम	شفقة	शफकत		
शब	फारसी	रात्रि				
शबाब	अरबी	यौवनावस्था, सौन्दर्य, युवावस्था, यौवनकाल		शवाब		
शम्स	अरबी	सूर्य				
शर्त	अरबी	प्रतिज्ञा, पण, नियम,  		शर्तें, शर्तों		
शर्बत	अरबी	रस		शरबत		
शर्म	फारसी	लज्जा, सङ्कोच		शरम		
शर्मनाक	फारसी	लज्जाजनक, लज्जास्पद		शरमनाक		
शर्मसार	फारसी	लज्जित, लज्जावान, लज्जाशील				
शर्मिंदगी	फारसी	लज्जा		शर्मिन्दगी, शरमिन्दगी		
शर्मिंदा	फारसी	लज्जित		शरमिंदा, शरमिन्दा		
शराफत	अरबी	भद्रता, सज्जनता, शिष्टता, भलमनसी,				
शराब	अरबी	मद्य, मदिरा				
शराबी	अरबी+फारसी	मद्यप,				
शरारत	अरबी	चंचलता				
शरारतपूर्ण	अरबी+हिन्दी					
शरारती	अरबी	नटखट, चंचल				
शरीफ	अरबी	सभ्य, सज्जन, प्रतिष्ठित, शिष्ट				
शह	फारसी	राजा, भडकाना				
शहद	अरबी	मधु, पुष्परस				
शहंशाह	फारसी	सम्राट		शहन्शाह, शहनशाह, शहेंशाह, शहेन्शाह, शहेनशाह		
शहर	फारसी	नगर, पुर		शहरी, शहरों		
शहरयार	फारसी	नृपति , शासक				
शहादत	अरबी	वीरगति				
शहीद	अरबी	[मूल अर्थ: इस्लाम के लिए बलिदान देने वाला] हुतात्मा, बलिदानी		शहीदों, शहीदी		
शागिर्द	फारसी	शिष्य, चेला, विद्यार्थी		शागिर्दों, शागिर्दो,		
शाद	फारसी	प्रसन्न, आनंदित, पूर्ण,				
शादकाम	फारसी	प्रसन्न, सफल,				
शादकामी	फारसी	प्रसन्नता				
शादी	फारसी	विवाह, लग्न		शादियों, शादियो, शादीयों, शादीयो, शादियां, शादियाँ		
शादीशुदा	फारसी	विवाहित				
शातिर	अरबी	धूर्त, धृष्ट				
शान	अरबी	शोभा, गर्व				
शानदार	अरबी+फारसी	भव्य, उत्कृष्ट, आकर्षक, तेजस्वी				
शाबाश	फारसी	साधुवाद, साधु				
शाम	फारसी	सन्ध्या, साँझ	شام	शामें, शामों		
शामिल	अरबी	समाविष्ट, सम्मिलित, समावेश				
शायद	फारसी	कदाचित्, सम्भवतः				
शायर	अरबी	कवि				
शायरा	अरबी	कवयित्री				
शायरी	अरबी+फारसी	कविता, काव्य				
शाह	फारसी	राजा				
शाहज़ादा	फारसी	राजकुमार		शहजादा, शहजादे, शाहजादे, शहजादें, शाहजादें, शहजादों, शाहजादों, शहजादो, शाहजादो		
शाही	फारसी	राजसी				
शिकन	फारसी	ऊर्मिका				
शिकवा	अरबी	उलाहना, उपालंभ, विलाप		शिकवे		
शिकस्त	फारसी	पराजय				
शिकायत	अरबी	अभियोग, दुःखकथन		शिकायतें, शिकायतों, शिकायतो		
शिकार	फारसी	आखेट, मृगया, पीडित,				
शिकारी	फारसी	आखेटक				
शिकारियो	फारसी	आखेटकों				
शिद्दत	अरबी	उग्रता, प्रचण्डता, तीव्रता, प्रबलता, भीषणता				
शैतान	अरबी	राक्षस, दैत्य	شيطان	शैतानों		
शुक्रगुजार	अरबी+फारसी	आभारी				
शुक्रिया	अरबी	धन्यवाद, आभार		शुक्रीया		
शुगर	आङ्ग्लभाषा	शर्करा	sugar			
शुरू	अरबी	आरम्भ, प्रारम्भ		शुरु		
शुरुआत	अरबी	आरम्भ, प्रारम्भ		शुरूआत, शुरुवात, शुरूवात, शूरुआत, शूरूआत, शूरुवात, शूरूवात		
शुरुआती	अरबी	प्रारम्भिक				
शेख़ी	तुर्की	डींग, घमंड, अभिमान,				
शेख़ीख़ोर	तुर्की+फारसी	अहंकारी, डींग हाँकने वाला, ???				
शेखीबाज़	तुर्की+फारसी	अहंकारी, डींग हाँकने वाला, ???				
शेर	फारसी	सिंह, व्याघ्र, काव्यांश		शेरो		
शोर	फारसी	कोलाहल, उन्माद,				
शोहरत	अरबी	ख्याति, प्रसिद्धि, यश, प्रतिष्ठा		शौहरत		
शौक़	अरबी	रुचि				
शौकीन	अरबी	छैला, रसिक, रंगीला		शौकिन,		
शौहर	फारसी	पति				
						
स्कीम्	आङ्ग्लभाषा	योजना	scheme	स्कीम		
स्कूल्	आङ्ग्लभाषा	विद्यालय	school	स्कूलों, स्कूल		
स्टार्	आङ्ग्लभाषा	तारा	star	स्टार		
स्टारकास्ट	आङ्ग्लभाषा	???	starcast			
	आङ्ग्लभाषा		statue			
स्टेज्	आङ्ग्लभाषा	मञ्च, चरण, अवस्था, 	stage	स्टेज, 		
स्टेडियम्	आङ्ग्लभाषा	क्रीडाङ्गण, 	stadium 	स्टेडियम		
स्ट्रोन्ग्	आङ्ग्लभाषा	सशक्त, सबल, दृढ, तीव्र,	strong	स्ट्रॉन्ग, स्ट्रोन्ग		
स्टोरी 	आङ्ग्लभाषा	कथा , वार्ता	story			
स्टोरेज्	आङ्ग्लभाषा	संग्रह, सञ्चय	storage	स्टोरेज		
स्पीच्	आङ्ग्लभाषा	भाषण, वक्तव्य, कथन, 	speech	स्पीच		
स्पीड्	आङ्ग्लभाषा	गति, वेग	speed	स्पीड		
स्पोर्ट्	आङ्ग्लभाषा	क्रीडा, खेल, 	sport	स्पोर्ट		
स्पोर्ट्स्	आङ्ग्लभाषा	क्रीडा, खेल, 	sports 	स्पोर्ट्स		
स्याही	फारसी	मसि, कज्जल				
स्वाइन्	आङ्ग्लभाषा	शूकर, सुअर, 	swine	स्वाइन		
सख़्त	फारसी	कठोर, दृढ़, प्रखर, अतिशय		सखत, 		
सख़्ती	फारसी	कठोरता, कठिनता, निष्करुणा				
सजदा	अरबी	अल्लाह को प्रणाम		सज्दा		
सज़ा	फारसी	दण्ड				
सजावल	तुर्की	राजकर्मचारी				
सदमा	अरबी	आघात, क्षोभ		सदमे		
सदी	फारसी	शताब्दी, शती				
सदियों	फारसी	शताब्दियों				
संदूक़	अरबी	पेटी				
सनद	अरबी	प्रमाणपत्र, प्रमाण				
सनम	अरबी	प्रियतम, प्रिय, प्रेमी				
सप्लाइ	आङ्ग्लभाषा	आपूर्ति	supply	सप्लाई		
सपोर्ट	आङ्ग्लभाषा	समर्थन, सहयोग, सहायता	support			
सफ़र	अरबी	यात्रा				
सफ़रनामा	अरबी+फारसी	भ्रमणवृतांत, यात्रा-विवरण				
सफ़हा	अरबी	पृष्ठ,		सफ्हा		
सफा	अरबी	पवित्र, पृष्ठ, शुद्ध		सफे		
सफाई	अरबी+फारसी	स्वच्छता, निर्मलता		सफाइ		
सफेद	फारसी	श्वेत, धवल				
सब्जी	फारसी	साग, शाक, शाकभाजी				
सब्र	अरबी	धैर्य				
सबक	अरबी	पाठ, शिक्षा				
सबब	अरबी	कारण, हेतु				
सबूत	अरबी	प्रमाण		सबुत, सबूतों,		
समझदार	हिन्दी+फारसी	बुद्धिमान				
समझदारी	हिन्दी+फारसी	विचारशीलता, बुद्धिमत्ता, विवेक				
समंदर	फारसी	समुद्र		समुंदर, समुंदरो, समंदरो, समन्दर		
समा	अरबी	आकाश, गगन, दृश्य, व्योम		समां, समाँ		
समिट्	आङ्ग्लभाषा	सम्मेलन 	summit 	समिट 		
सर्कुलेशन्	आङ्ग्लभाषा	परिभ्रमण, प्रसार,	circulation 	सर्कुलेशन		
सर्टिफिकेट्	आङ्ग्लभाषा	प्रमाणपत्र 	certificate 	सर्टिफिकेट , सर्टिफिकेट्स, सर्टीफिकेट		
सर्दी	फारसी	ठण्ड, शीत				
सर्विस्	आङ्ग्लभाषा	सेवा,  व्यापार,  व्यावसाय, 	service 	सर्विस, सर्विसेज, 		
सरकार	फारसी	राज्य, शासन, प्रभुत्व		सरकारें, सरकारों		
सरकारी	फारसी	राजकीय, शासकीय				
सरगर्दां	फारसी	व्याकुल, चिंतित				
सरताज	फारसी	मुकुट, मुख्य, अग्रगण्य, नायक				
सरदार	फारसी	नायक, नेता, प्रमुख		सरदारों, सरदारो		
सरदी	फारसी	प्रतिश्याय, पीनस,				
सरहद	अरबी	सीमा		सरहदें, सरहदे		
सरासर	फारसी	पूर्णतया, प्रत्यक्ष, स्पष्टतः, साक्षात्, 				
सरिश्ता	फारसी	कार्यालय, न्यायालय				
सरेआम	अरबी+फारसी	सार्वजनिक				
सरेंडर्	आङ्ग्लभाषा	आत्मसमर्पण	surrender 	सरेंडर		
सरेराह	फारसी	बीच सडक				
सल्तनत्	अरबी	राज्य, साम्राज्य		सल्तनत		
सलाम	अरबी	नमस्कार, प्रणाम, वन्दन		सलामी		
सलामत	अरबी	कुशल, क्षेम, सुरक्षित	سلامت			
सलामती	अरबी+फारसी	सुरक्षा, स्वास्थ्य				
सलाह	अरबी	परामर्श, उपदेश		सलाहों		
सलीका	अरबी	सभ्यता, शिष्टता, योग्यता, ढङ्ग, व्यवहार		सलीके		
सलूक	अरबी	व्यवहार				
सवाल	अरबी	प्रश्न		सवालों, सवालो		
सस्पेण्ड्	आङ्ग्लभाषा	निलम्बित 	suspend	सस्पेंड , सस्पेण्ड		
सहर	अरबी	प्रातःकाल, प्रभात, सवेरा				
सहूलियत	अरबी	सुगमता, सुविधा, सरलता				
सही	अरबी	सत्य, उचित, वास्तव, योग्य, यथार्थ, शुद्ध, प्रामाणिक				
साइन्स्	आङ्ग्लभाषा	विज्ञान	science 	सायंस, साइन्स, साइंस		
साऊथ्	आङ्ग्लभाषा	दक्षिण	south	साउथ, साऊथ		
साकी	अरबी	मदिरा पिलाने वाली व्यक्ति				
साजिश	फारसी	षड़यन्त्र, कुचक्र		साजिशें		
साफ	अरबी	स्पष्ट, स्वच्छ, शुद्ध, निर्मल				
सानेहा	अरबी	दुर्घटना				
साबुन	अरबी	मार्जनलेप, ???	صابون			
साबुनफरोश	अरबी	???				
साबुनसाज	अरबी	???				
साबुनसाजी	अरबी	???				
साबित	अरबी	सिद्ध, प्रमाणित				
सामान	फारसी	वस्तुएँ , उपकरण, सामग्री				
साल	फारसी	वर्ष, वत्सर, अब्द		सालो, सालों, સાલ, 		
सालगिरह	फारसी	वर्षगाँठ				
सालभर	फारसी	वर्षपर्यंत				
सालाना 	फारसी	वार्षिक 				
साहब	अरबी	श्रीमान, महोदय, महाशय		साहेब, साहिब, भाईसाहब		
साहिल	अरबी	तट				
सिक्योर्	आङ्ग्लभाषा	सुरक्षित	secure	सिक्युर, सिक्योर		
सिक्योरिटी	आङ्ग्लभाषा	सुरक्षा	security	सिक्युरिटी, सिक्योरिटीज		
सीक्रेट्	आङ्ग्लभाषा	रहस्य, गुप्त,	secret	सीक्रेट, सीक्रेट्स, 		
सितम	फारसी	अन्याय, अत्याचार, अनीति				
सितारा	फारसी	तारा		सितारों, सितारे, सितारें		
सिफर	अरबी	शून्य, रिक्त, अयोग्य, तुच्छ				
सिफ़ारिश	फारसी	संस्तुति, गुणवर्णन, उपदेश, प्रेरणा				
सिर्फ	अरबी	केवल, मात्र				
सिरदर्द	फारसी	शिरोवेदना, शिर्षवेदना, चिन्ता		सरदर्द		
सियासत	अरबी	राजनीति				
सियासी	अरबी	राजनैतिक				
सियाह	फारसी	दूषित, अशुभ,				
सियाहकार	फारसी	दुश्चरित्र				
सियाहकारी	फारसी	अपराध				
सियाहगोश	फारसी	???				
सियाहचश्म	फारसी	???				
सियाहजबाँ	फारसी	???				
सियाहदस्त	फारसी	कञ्जूस				
सियाहदाना	फारसी	काला जीरा				
सियाहपोश	फारसी	निष्ठुर, क्रूर				
सियाहबख्ती	फारसी	दुर्भाग्य				
सियाहमस्त	फारसी	मदमत्त				
सियाहरू	फारसी	पापी				
सियाहवक्त	फारसी	अभागा				
सियाहसफेद	फारसी	हित अहित				
सिल्वर	आङ्ग्लभाषा	रजत	silver			
सिलसिला	आङ्ग्लभाषा	क्रम, परम्परा, शृङ्खला		सिलसिले		
सिवा	फारसी	अतिरिक्त		सिवाय		
सिस्टम्	आङ्ग्लभाषा	तन्त्र, प्रणाली, व्यवस्था	system 	सिस्टम, सिस्टम्स		
सिस्टर्	आङ्ग्लभाषा	स्वसा, भगिनी, बहन, उपचारिका, 	sister	सिस्टर, सिस्टर्स, 		
सुकून	अरबी	शान्ति		सुकुन , सुकूं, सुकूँ,		
सुनामी	जापानी	???				
सुप्रीम्	आङ्ग्लभाषा	सर्वोच्च, परम, उच्चतम, 	supreme 	सुप्रीम		
सुपुर्द	फारसी	हस्तांतरित				
सुपोर्ट	आङ्ग्लभाषा	समर्थन	support 	सपोर्ट		
सुब्हानी	अरबी	ईश्वरीय , अलौकिक		सुबहानी		
सुबह	अरबी	प्रातःकाल, प्रभात, सवेरा		सुबहों, सुबहें, सुब्ह		
सुर्ख	फारसी	रक्तवर्ण				
सुर्खचश्म	फारसी	रक्तनेत्र				
सुर्खपोश	फारसी	रक्ताम्बर				
सुर्खरंग	फारसी	रक्तवर्ण				
सुराख	फारसी	छिद्र, छेद				
सुराग	अरबी	सङ्केत				
सुरागसाँ	अरबी	गुप्तचर				
सुरागसी	अरबी	अन्वेषण				
सुरूर	अरबी	मद, प्रमाद, मादकता, उन्माद, आनन्द		सूरूर, सुरुर, सूरुर		
सुल्तान	अरबी	सम्राट		सुलतान		
सुहाना	???	रमणीय, मनोज्ञ, सुन्दर		सुहानी		
सूद	फारसी	ब्याज				
सेक्टर्	आङ्ग्लभाषा	क्षेत्र, विभाग, शाखा, खण्ड, 			^सेक्टर(्|्स्|्स)?$	
सेक्स्	आङ्ग्लभाषा	समागम, मैथुन	sex	सेक्स		
सेकण्ड्	आङ्ग्लभाषा	क्षण, द्वितीय,	second	सेकंड, सेकण्ड		
सेंचुरी	आङ्ग्लभाषा	शतक, शताब्दी	century			
सेन्टर्	आङ्ग्लभाषा	केन्द्र	center	सेन्टर, सेंटर, सेंटर्स		
सेशन्	आङ्ग्लभाषा	सत्र, बैठक, अधिवेशन, सभा, 	session 	सेशंस, सेशन		
सेहत	अरबी	स्वास्थ्य, आरोग्य				
सेहतयाब	फारसी	स्वस्थ, निरोगी				
सोशल	आङ्ग्लभाषा	सामाजिक	social 	सोशियल		
सोसाइटी 	आङ्ग्लभाषा	समाज 	society 	सोसायटी 		
सोहबत	अरबी	साथ, सङ्गम, समागम				
सॉल्यूशन	आङ्ग्लभाषा	समाधान, विलयन	solution			
सैल्यूट	आङ्ग्लभाषा	वन्दन, नमन 	salute			
सैलरी	आङ्ग्लभाषा	वेतन	salary			
सैलाब	अरबी+फारसी	जलप्रपात, जलप्रलय,				
सौगात	तुर्की	उपहार, भेंट				
सौदा	अरबी	क्रय विक्रय, व्यापार वाणिज्य		सौदे		
सौदागर	अरबी+फारसी	व्यापारी		सौदागरों		
सौदागरी	अरबी+फारसी	व्यापार				
						
हक	अरबी	अधिकार		हुकूक, 		
हकदार	अरबी+फारसी	अधिकारी				
हकीकत	अरबी	यथार्थता, सत्य, वास्तविकता				
हजम	अरबी	पाचन				
हजरत	अरबी	महोदय				
हजामत	अरबी	क्षौर				
हजार	फारसी	सहस्र, दशशत	هزار	हजारों, हज़ारो		
हद	अरबी	सीमा, पराकाष्ठा		हदों, हदें,		https://en.m.wiktionary.org/wiki/%D9%87%D8%B2%D8%A7%D8%B1
हदबंदी	अरबी	सीमाङ्कन				
हंगामा	फारसी	उपद्रव, उन्माद		हन्गामा, हंगामे, हन्गामे, हङ्गामा		
हनक	अरबी	उन्माद, अभिमान, प्रभाव				
हफ्ता	फारसी	सप्ताह		हफ्ते		
हब्	आङ्ग्लभाषा	केन्द्र	hub	हब 		
हमउम्र	फारसी+अरबी	समवयस्क				
हमदम	???	मित्र, साथी, सखा, बन्धु, सुहृत्, वयस्य, स्निग्ध				
हमदर्द	फारसी	???				
हमदर्दी	फारसी	सहानुभूति, संवेदना				
हमराह	फारसी	सहगामी, सहयात्री		हमराही		
हमला	अरबी	आक्रमण, वार, चढ़ाई, प्रहार		हमले, हमलों		
हमलावर	अरबी	प्रहारक, आक्रमणकारी		हमलावरों		
हमसफर	अरबी	सहयात्री				
हमेशा	फारसी	सदा, सर्वदा, सदैव				
हया	अरबी	लज्जा				
हयात	अरबी	जीवन, 				
हर्ज	अरबी	हानि				
हर्जाना	अरबी	क्षतिपूर्ति, निष्कृति, प्रतिफल		हर्जाने		
हर्फ	अरबी	अक्षर, वर्ण,		हरफ		
हरकत	अरबी	चेष्टा, कर्म, गति, दुष्कर्म		हरकतों, हरकतो, हरकतें, हरकते		
हराम	अरबी	जो इस्लाम मे निषिद्ध है, वर्जित				
हरामखोर	अरबी+फारसी	नीच, पापी, दुष्ट,		हरामखोरो, हरामखोरों		
हरामजादा	अरबी+फारसी	वर्णसंकर, दुष्ट		हरामजादे, हरामजादी		
हरामी	अरबी+फारसी	नीच, पापी, दुष्ट,		हरामियों		
हरावल	तुर्की	???				
हलफनामा	अरबी	शपथपत्र				वह थोड़ी-सी सेना जो लश्कर के आगे चलती है; सेना का अगला भाग; सिपाहियों का वह दल जो फ़ौज में सबसे आगे रहता है; इस प्रकार आगे चलने वाली सेना के सेनापति।
हलवा	अरबी	मोहनभोग		हलुआ		
हलीम	अरबी	सहनशील, गम्भीर, शांत, मुहर्रम की खिचड़ी				
हवस	अरबी	कामना, कामवासना, बुद्धिविकार				
हवसी	अरबी	विषयी, व्यभिचारी, कामातुर				
हवा	अरबी	वायु, पवन, समीर, अनिल, गति		हवाएं, हवाओ, हवाओं, हवाए		
हवाला	अरबी	सन्दर्भ, उदाहरण, उल्लेख, दृष्टान्त				
हवालाबाज	अरबी	???		हवालाबाजो, हवालाबाजों		
हवाले	अरबी	हस्तान्तरण				
हसरत	अरबी	कामना		हसरतें, हसरतों		
हसीन	अरबी	सुन्दर				
हसीना	अरबी	सुन्दरी				
हश्र	अरबी	अन्त, दशा				
हाइकोर्ट्	आङ्ग्लभाषा	उच्च न्यायलय	highcourt	हाईकोर्ट, हाइकोर्ट		
हाईवे	आङ्ग्लभाषा	राजमार्ग, मुख्यमार्ग, राजपथ, 	highway			
हाउस्	आङ्ग्लभाषा	घर, गृह, 	house	हाउस		
हाकिम	अरबी	शासक, प्रधान				
हाजमा	अरबी	पाचनक्रिया, पाचनशक्ति				
हाजिर	अरबी	उपस्थित, प्रस्तुत				
हाजिरी	अरबी	उपस्थिति				
हादसा	अरबी	दुर्घटना, अकस्मात		हादसे, हादसें, हादसों , हादसो		
हादी	अरबी	मार्गदर्शक				
हायर्	आङ्ग्लभाषा	प्रयुज्, नियुज्, उच्चतर, 	hire / higher	हायर		
हार्ट्	आङ्ग्लभाषा	हृदय	heart	हार्ट		
हाल	अरबी	अवस्था, दशा, परिस्थिति, वर्तमान				
हालत	अरबी	अवस्था, दशा, परिस्थिति		हालतें, हालते		
हालात	अरबी	स्थितियां, परिस्थितियां		हालातों, हालातो		
हालांकि	अरबी+फारसी	यद्यपि		हालाँकि, हालाकि		
हालिया	अरबी	वर्तमान				
हास्पिटल्	आङ्ग्लभाषा	चिकित्सालय	hospital	हास्पिटल		
हासिल	अरबी	प्राप्त				
हिज्र	अरबी	वियोग				
हिजड़ा	उर्दू	नपुंसक		हिजड़े, हिजड़ों		
हिदायत	अरबी	उपदेश, अनुदेश, आज्ञा		हिदायतें		
हिफ़ाज़त	अरबी	रक्षा, सुरक्षा,		हिफ़ाजतो, हिफ़ाजतों		
हिम्मत	अरबी	साहस, वीरता, पौरुष, पराक्रम		हिम्मते , हीम्मत		
हिरासत	अरबी	अभिरक्षा				
हिरासाँ	फारसी	निराश, भयभीत,				
हिस्सा	अरबी	भाग, अंश		हिस्से , हिस्सों		
हिस्सेदार	अरबी+फारसी	सहभागी, अंशधारी, साथी				
हिस्सेदारी	अरबी+फारसी	सहभागिता, सहकारिता				
हिसाब	अरबी	गणित, गणना, तर्क, लेखा-जोखा				
हुक्म	अरबी	आदेश		हुकम, हुकुम, हुकूम,		
हुक्मरान	अरबी+फारसी	शासक		हुक्मराँ, हुक्मरानो, हुक्मरानों		
हुकूमत	अरबी	शासन, राज्य, अधिकार, प्रभुत्व		हकूमत		
हुजूम	अरबी	जनसमूह,				
हुज़ूर	अरबी	श्रीमान, महोदय				
हुनर	फारसी	गुण, योग्यता, कौशल				
हुलिया	अरबी	मुखाकृति				
हुस्न	अरबी	सौन्दर्य, सुन्दरता				
हूबहू	अरबी+फारसी	???				
हेड्मास्टर्	आङ्ग्लभाषा	प्रधानाध्यापक	headmaster 	हेडमास्टर, हेडमास्टर्		
हेल्थ्	आङ्ग्लभाषा	स्वास्थ्य	health	हेल्थ		
हैरत	अरबी	आश्चर्य				
हैरान	अरबी	विचलित, व्याकुल, अचंभित				
हैरानी	अरबी	आश्चर्य, विस्मय, व्यग्रता				
हैरिटेज्	आङ्ग्लभाषा	पैतृकधन, पैतृकाधिकार, परम्परा, 	heritage 	हैरिटेज		
हैवान	अरबी	पशु		हैवानो, हैवानों		
हैवानियत	अरबी	पशुता				
हैसियत	अरबी	प्रतिष्ठा, योग्यता, सामर्थ्य,				
होटल् 	आङ्ग्लभाषा	उत्तरणशाला, प्रवासीयगृह, उत्तरणगृह, 	hotel	होटल, होटल्स, होटल्स्		
होश	फारसी	चेतना, सुधबुध, बुद्धि				
होशियार	फारसी	बुद्धिमान, कुशल, दक्ष, चतुर, प्रवीण, निपुण				
होशियारी	फारसी	बुद्धिमानी, कौशल, चतुराई, प्रवीणता, निपुणता				
होशोहवास	फारसी	सुध-बुध				
हौज	अरबी	कुण्ड, जलाशय				
हौद	अरबी	कुण्ड, जलाशय				
हौसला	अरबी	सामर्थ्य, उत्साह, साहस		हौसलों, होंसला, हौसले, हौसलो, हौंसले, हौसले		